business_id,inspection_score_median,inspection_score_mean,inspection_score_min,High Risk,Low Risk,Moderate Risk,No Risk,total_number_of_violations
19,94.0,94.66666666666667,94.0,0,1,2,0,3
24,98.0,98.0,98.0,0,2,0,1,3
31,95.0,95.0,94.0,0,3,1,0,4
45,88.0,88.0,85.0,1,12,4,0,17
48,87.0,89.8,87.0,1,2,2,0,5
54,87.0,89.8,87.0,1,2,2,0,5
58,74.0,74.80952380952381,70.0,3,10,8,0,21
61,94.0,94.8,94.0,0,3,2,0,5
66,97.0,97.0,96.0,0,4,0,0,4
73,83.0,83.85714285714286,78.0,0,7,7,0,14
76,98.0,98.66666666666667,98.0,0,2,0,1,3
77,94.0,94.66666666666667,94.0,0,4,2,0,6
80,96.0,97.33333333333333,96.0,0,2,0,1,3
88,84.0,85.6,82.0,4,5,1,0,10
95,88.5,88.0,83.0,2,11,3,0,16
98,94.0,95.33333333333333,94.0,0,2,1,0,3
99,83.0,83.0,82.0,0,7,5,0,12
101,90.0,90.8,90.0,0,1,4,0,5
102,86.0,88.0,85.0,1,4,7,0,12
108,100.0,100.0,100.0,0,2,0,2,4
116,74.0,81.44444444444444,74.0,3,2,4,0,9
121,90.0,89.5,88.0,0,3,9,0,12
125,90.0,92.0,90.0,0,3,1,1,5
134,85.0,87.0,85.0,2,0,2,0,4
140,79.0,80.06666666666666,77.0,2,4,9,0,15
141,100.0,100.0,100.0,0,0,0,3,3
146,84.0,84.23076923076923,81.0,1,5,7,0,13
151,81.0,81.0,81.0,1,2,2,0,5
155,86.0,84.53846153846153,79.0,1,5,7,0,13
164,87.0,87.22222222222223,83.0,2,2,5,0,9
184,90.0,91.5,90.0,0,1,3,0,4
187,94.0,95.0,92.0,0,0,3,1,4
190,100.0,100.0,100.0,0,0,0,3,3
192,86.0,86.0,86.0,2,0,0,0,2
194,84.0,84.8,84.0,0,5,5,0,10
198,94.0,94.0,94.0,0,2,2,0,4
200,88.0,88.0,88.0,0,2,2,0,4
208,90.0,90.0,90.0,0,6,2,0,8
217,92.0,90.63636363636364,88.0,1,6,4,0,11
226,84.0,81.06666666666666,74.0,2,6,7,0,15
236,94.0,94.6,93.0,1,3,1,0,5
239,88.0,88.0,88.0,0,4,4,0,8
240,82.0,80.72222222222223,77.0,2,11,5,0,18
247,88.0,87.84615384615384,86.0,0,8,5,0,13
251,98.0,98.0,98.0,0,2,0,0,2
253,94.0,93.55555555555556,92.0,0,9,0,0,9
256,90.0,92.0,90.0,0,5,1,0,6
268,82.0,85.6,82.0,2,2,0,1,5
272,79.0,79.0,79.0,1,3,2,0,6
273,83.0,80.58333333333333,75.0,3,15,6,0,24
275,96.0,95.6,94.0,0,4,1,0,5
276,100.0,100.0,100.0,0,0,0,3,3
279,92.0,92.44444444444444,90.0,0,5,4,0,9
281,98.0,98.0,98.0,0,1,0,0,1
283,81.0,84.375,81.0,1,3,4,0,8
286,83.0,82.8695652173913,82.0,2,16,5,0,23
290,98.0,98.0,98.0,0,1,0,0,1
298,88.0,88.72727272727273,87.0,1,7,3,0,11
300,86.0,86.0,86.0,0,3,2,0,5
302,94.0,89.92857142857143,81.0,1,10,3,0,14
305,88.0,88.85714285714286,88.0,0,3,4,0,7
315,87.0,88.0909090909091,84.0,1,2,8,0,11
318,96.0,96.0,94.0,0,5,1,0,6
320,81.0,81.41176470588235,77.0,2,10,5,0,17
323,96.0,95.6,94.0,0,4,1,0,5
326,78.0,79.33333333333333,78.0,3,2,4,0,9
328,82.0,82.9090909090909,81.0,4,3,4,0,11
337,90.0,89.6,89.0,1,1,3,0,5
379,77.0,78.33333333333333,77.0,4,4,7,0,15
384,76.0,76.45454545454545,73.0,5,2,4,0,11
386,68.0,74.85714285714286,68.0,2,7,5,0,14
389,98.0,98.0,96.0,0,1,1,1,3
393,81.0,79.4375,76.0,4,7,5,0,16
397,96.0,96.0,96.0,0,0,1,0,1
400,90.0,90.0,90.0,0,1,2,0,3
403,88.0,89.2,88.0,0,5,5,0,10
409,66.0,71.66666666666667,66.0,3,3,6,0,12
413,74.0,74.0,74.0,2,2,2,0,6
415,92.0,92.4,91.0,1,1,3,0,5
422,96.0,96.0,96.0,0,0,1,0,1
423,78.0,83.33333333333333,78.0,2,5,2,0,9
424,86.0,87.42857142857143,86.0,0,9,5,0,14
428,98.0,98.0,98.0,0,2,0,0,2
429,87.0,87.0,87.0,2,4,2,0,8
431,86.0,86.5,86.0,0,4,8,0,12
435,92.0,90.85714285714286,88.0,0,1,6,0,7
436,87.0,86.6,86.0,2,3,5,0,10
438,77.0,79.91666666666667,77.0,1,6,5,0,12
442,83.0,83.88888888888889,83.0,2,5,2,0,9
448,88.0,88.0,88.0,0,0,3,0,3
462,99.0,99.0,98.0,0,1,0,1,2
463,88.0,88.0,88.0,0,0,3,0,3
470,92.0,92.0,92.0,0,4,0,0,4
473,90.0,90.0,90.0,0,3,1,0,4
475,90.0,90.0,90.0,0,6,2,0,8
477,92.0,93.6,92.0,0,4,1,0,5
479,82.0,85.75,82.0,0,3,5,0,8
480,80.0,80.85714285714286,80.0,4,1,2,0,7
483,93.5,93.5,91.0,1,3,0,0,4
484,98.0,98.0,98.0,0,2,0,0,2
485,96.0,96.0,96.0,0,4,0,0,4
486,85.0,89.6,85.0,2,0,2,1,5
488,90.5,90.5,89.0,1,0,3,0,4
489,80.0,78.79166666666667,75.0,4,12,8,0,24
494,94.0,94.0,94.0,0,2,2,0,4
496,94.0,93.2,92.0,0,3,2,0,5
500,89.0,88.2,83.0,2,3,5,0,10
502,94.0,95.33333333333333,94.0,0,2,1,0,3
507,90.0,89.33333333333333,86.0,0,9,6,0,15
509,88.0,87.55555555555556,87.0,1,7,1,0,9
510,87.0,86.93333333333334,86.0,2,7,6,0,15
519,92.5,92.5,91.0,1,2,1,0,4
522,88.0,89.71428571428571,88.0,0,4,3,0,7
529,87.0,88.28571428571429,87.0,1,4,2,0,7
538,88.0,89.2,88.0,0,5,5,0,10
539,90.0,90.0,88.0,0,2,8,0,10
542,84.0,84.5,80.0,2,12,10,0,24
544,74.0,75.05882352941177,72.0,6,7,4,0,17
547,90.0,88.36363636363636,84.0,0,6,5,0,11
551,81.0,83.8,76.0,4,11,5,0,20
552,84.0,83.84210526315789,81.0,2,10,7,0,19
557,83.0,82.18181818181819,76.0,3,4,4,0,11
562,89.0,89.0,89.0,1,0,1,0,2
580,91.0,90.11111111111111,85.0,1,6,2,0,9
587,70.0,75.4,70.0,2,2,6,0,10
588,86.0,86.5,84.0,1,7,4,0,12
589,82.0,82.53846153846153,81.0,4,6,3,0,13
591,90.0,89.57142857142857,89.0,1,5,1,0,7
606,78.0,78.21739130434783,75.0,4,9,10,0,23
615,89.0,88.77777777777777,86.0,1,4,4,0,9
619,86.0,84.4,78.0,2,13,5,0,20
625,86.0,86.85714285714286,86.0,0,1,6,0,7
628,79.0,78.37037037037037,74.0,2,18,7,0,27
631,87.0,84.81818181818181,81.0,3,4,4,0,11
639,94.0,93.33333333333333,92.0,0,2,4,0,6
642,90.0,92.4,90.0,0,3,2,0,5
645,94.0,93.66666666666667,93.0,1,1,1,0,3
665,83.0,83.9375,80.0,5,9,2,0,16
670,85.0,82.14285714285714,75.0,2,11,8,0,21
691,80.0,85.14285714285714,80.0,2,3,2,0,7
703,73.0,73.0,73.0,1,2,4,0,7
709,87.0,87.0,87.0,1,1,1,0,3
726,77.0,76.9,72.0,9,7,4,0,20
741,87.0,89.8,87.0,1,2,2,0,5
744,96.0,95.33333333333333,92.0,0,4,2,0,6
754,92.0,94.0,92.0,0,1,2,0,3
758,90.0,91.6,90.0,0,2,3,0,5
768,92.0,92.0,92.0,0,2,1,0,3
773,96.0,96.66666666666667,96.0,0,3,0,0,3
774,90.0,91.71428571428571,90.0,0,7,0,0,7
782,92.0,93.33333333333333,92.0,0,0,3,0,3
786,90.0,90.57142857142857,86.0,2,3,2,0,7
792,94.0,91.61538461538461,85.0,1,8,4,0,13
795,96.0,96.4,96.0,0,5,0,0,5
798,94.0,90.08333333333333,83.0,1,10,1,0,12
799,99.0,99.0,98.0,0,1,0,1,2
811,58.0,64.54545454545455,58.0,4,4,3,0,11
816,88.0,87.1,85.0,1,2,7,0,10
824,77.0,75.8,71.0,6,3,6,0,15
826,90.0,91.53846153846153,90.0,0,10,3,0,13
827,84.0,84.0,83.0,4,4,3,0,11
835,87.0,87.0,86.0,0,7,3,0,10
840,87.0,87.0,87.0,1,1,1,0,3
845,92.0,94.0,92.0,0,1,2,0,3
847,92.0,92.8,92.0,0,3,2,0,5
852,83.0,83.0,83.0,1,5,0,0,6
854,79.0,83.33333333333333,79.0,1,5,3,0,9
856,92.0,92.8,92.0,0,0,5,0,5
874,90.0,89.0,85.0,1,6,4,0,11
876,83.0,81.05,74.0,4,9,7,0,20
884,90.0,87.58333333333333,83.0,1,8,3,0,12
886,96.0,96.0,96.0,0,2,1,0,3
891,85.0,87.71428571428571,84.0,1,8,5,0,14
892,87.0,87.9090909090909,86.0,1,6,4,0,11
902,94.0,96.4,94.0,0,3,0,2,5
903,90.5,91.66666666666667,90.0,1,3,2,0,6
905,87.0,90.6,87.0,1,3,1,0,5
917,92.0,94.66666666666667,92.0,0,0,2,1,3
919,96.0,96.0,96.0,0,2,3,0,5
920,92.0,93.33333333333333,92.0,0,0,4,2,6
929,89.0,89.0,89.0,1,0,1,0,2
935,88.0,88.8,87.0,1,5,4,0,10
941,90.0,90.0,90.0,0,3,1,0,4
943,76.0,79.3,76.0,1,3,6,0,10
949,90.0,90.2,87.0,2,5,3,0,10
950,90.5,91.16666666666667,85.0,1,2,3,0,6
952,88.0,85.3076923076923,81.0,1,6,6,0,13
961,96.0,94.28571428571429,92.0,0,6,1,0,7
972,90.0,87.77777777777777,83.0,1,3,5,0,9
984,65.0,72.69565217391305,65.0,6,6,11,0,23
985,71.0,71.0,67.0,4,5,5,0,14
994,94.0,94.0,92.0,0,2,2,0,4
999,80.0,79.05263157894737,77.0,1,8,10,0,19
1000,74.0,73.78947368421052,72.0,6,8,5,0,19
1002,90.0,88.72727272727273,85.0,1,7,3,0,11
1003,89.0,89.0,86.0,0,9,3,0,12
1005,84.0,82.91666666666667,78.0,0,16,8,0,24
1008,85.0,76.94117647058823,66.0,3,8,6,0,17
1018,87.0,86.36363636363636,83.0,2,5,4,0,11
1021,90.0,87.75,82.0,2,3,3,0,8
1026,71.0,71.0,71.0,1,5,3,0,9
1031,83.5,83.5,82.0,3,0,3,0,6
1036,85.0,85.0,85.0,1,4,0,0,5
1042,92.0,94.0,92.0,0,1,2,0,3
1043,83.0,84.71428571428571,83.0,2,2,3,0,7
1047,83.0,83.0,83.0,1,1,2,0,4
1065,86.0,84.91666666666667,81.0,1,4,7,0,12
1075,89.0,89.5,87.0,2,4,2,0,8
1081,89.0,90.0,88.0,1,1,5,0,7
1085,92.0,94.4,92.0,0,2,2,1,5
1090,74.0,77.0,74.0,2,5,1,0,8
1103,96.0,96.66666666666667,96.0,0,3,0,0,3
1111,90.0,88.71428571428571,87.0,1,4,2,0,7
1122,90.0,90.5,86.0,0,5,3,0,8
1124,80.0,82.66666666666667,80.0,2,3,1,0,6
1125,92.0,93.6,92.0,0,4,1,0,5
1127,96.0,96.0,96.0,0,2,1,0,3
1135,96.0,96.0,96.0,0,0,1,0,1
1139,69.0,69.0,69.0,3,3,1,0,7
1144,88.0,89.23076923076923,88.0,0,10,3,0,13
1146,77.0,77.0,77.0,1,2,3,0,6
1147,98.0,96.8,94.0,0,3,1,1,5
1154,46.0,56.294117647058826,46.0,5,5,7,0,17
1156,95.0,95.5,94.0,0,2,2,0,4
1188,100.0,100.0,100.0,0,0,0,2,2
1191,92.0,89.6,86.0,2,2,1,0,5
1193,96.0,96.0,96.0,0,4,0,0,4
1194,100.0,98.66666666666667,96.0,0,0,1,2,3
1199,81.0,84.375,81.0,1,3,4,0,8
1203,77.5,79.54545454545455,77.0,5,8,9,0,22
1219,85.0,87.4,85.0,2,1,2,0,5
1231,74.0,77.80952380952381,74.0,6,9,6,0,21
1232,84.0,84.85714285714286,80.0,0,9,5,0,14
1241,90.0,90.33333333333333,89.0,1,5,3,0,9
1243,90.0,89.875,87.0,1,3,4,0,8
1249,75.0,75.63157894736842,74.0,5,9,5,0,19
1261,88.0,89.33333333333333,88.0,0,4,2,0,6
1262,90.0,91.33333333333333,90.0,0,4,2,0,6
1263,94.0,93.66666666666667,93.0,1,1,1,0,3
1265,100.0,100.0,100.0,0,0,0,2,2
1269,93.0,93.66666666666667,92.0,0,4,2,0,6
1274,86.0,86.0,83.0,1,5,6,0,12
1280,92.0,92.25,92.0,1,2,1,0,4
1289,90.0,89.07692307692308,85.0,1,7,5,0,13
1294,94.5,94.5,93.0,1,0,1,0,2
1296,82.5,82.66666666666667,81.0,5,9,4,0,18
1300,90.0,83.07692307692308,74.0,2,7,4,0,13
1304,79.0,82.0,79.0,2,7,1,0,10
1318,86.0,85.22222222222223,80.0,6,2,1,0,9
1322,94.0,93.66666666666667,91.0,1,4,1,0,6
1323,94.0,94.0,94.0,0,4,1,0,5
1332,89.5,90.16666666666667,87.0,1,1,4,0,6
1337,88.0,87.07142857142857,84.0,3,6,5,0,14
1339,89.0,86.1875,80.0,1,11,4,0,16
1341,100.0,100.0,100.0,0,0,0,3,3
1344,96.0,96.0,96.0,0,0,1,0,1
1345,80.0,80.45454545454545,80.0,1,4,6,0,11
1347,92.0,90.66666666666667,88.0,0,10,2,0,12
1350,80.5,78.75,71.0,7,6,6,1,20
1351,100.0,100.0,100.0,0,0,0,1,1
1352,83.0,81.33333333333333,74.0,3,5,10,0,18
1354,88.0,88.0,86.0,0,4,4,0,8
1359,98.0,98.0,96.0,0,1,1,1,3
1362,81.0,82.16666666666667,80.0,4,4,4,0,12
1366,74.0,76.375,72.0,5,9,10,0,24
1368,98.0,98.0,98.0,0,3,0,0,3
1381,88.5,89.5,85.0,1,4,3,0,8
1389,82.0,83.3076923076923,78.0,6,4,3,0,13
1398,88.0,87.33333333333333,86.0,2,2,2,0,6
1399,97.0,96.25,93.0,1,2,1,0,4
1413,98.0,98.0,96.0,0,0,1,1,2
1426,70.0,69.4090909090909,67.0,6,7,9,0,22
1434,92.0,93.5,92.0,0,4,4,0,8
1442,94.0,92.28571428571429,90.0,0,3,4,0,7
1444,100.0,100.0,100.0,0,0,0,5,5
1452,89.0,88.77777777777777,87.0,2,4,3,0,9
1454,94.0,96.0,94.0,0,1,1,1,3
1466,95.5,95.5,91.0,1,1,0,2,4
1469,99.0,99.0,98.0,0,2,0,2,4
1482,74.0,74.0,74.0,2,2,2,0,6
1486,99.0,99.0,98.0,0,1,0,1,2
1487,96.0,94.25,90.0,0,5,2,1,8
1493,99.0,99.0,98.0,0,1,0,1,2
1496,91.0,92.66666666666667,91.0,1,1,1,0,3
1505,98.0,98.0,96.0,0,0,1,1,2
1508,90.0,90.0,90.0,0,4,3,0,7
1509,90.0,90.8,90.0,0,1,4,0,5
1520,100.0,98.66666666666667,96.0,0,0,1,2,3
1526,82.0,78.4375,71.0,4,7,5,0,16
1527,90.0,89.0,84.0,2,6,2,0,10
1529,98.0,98.0,98.0,0,2,0,0,2
1532,92.0,93.33333333333333,92.0,0,0,3,0,3
1534,88.0,89.0,88.0,1,3,2,0,6
1542,84.0,84.88235294117646,83.0,2,7,8,0,17
1544,98.0,98.66666666666667,98.0,0,2,0,1,3
1555,91.0,91.0,90.0,0,3,3,0,6
1564,96.5,96.5,93.0,1,0,0,1,2
1565,89.0,90.1,88.0,1,7,2,0,10
1568,90.0,90.85714285714286,90.0,0,5,2,0,7
1571,89.0,88.44444444444444,86.0,1,4,4,0,9
1579,92.0,91.45454545454545,90.0,0,5,6,0,11
1582,79.0,78.54545454545455,78.0,3,5,3,0,11
1584,87.0,83.07692307692308,77.0,2,6,5,0,13
1595,90.0,90.85714285714286,90.0,0,5,2,0,7
1596,90.0,92.4,90.0,0,3,2,0,5
1598,82.5,84.0,80.0,1,8,5,0,14
1608,92.0,91.77777777777777,90.0,0,6,3,0,9
1609,80.0,80.0,76.0,2,3,5,0,10
1614,95.0,95.66666666666667,94.0,0,5,0,1,6
1615,94.0,92.22222222222223,88.0,0,6,3,0,9
1617,71.0,72.15384615384616,69.0,9,10,7,0,26
1619,91.0,91.5,90.0,0,4,4,0,8
1626,88.0,88.0,88.0,0,0,3,0,3
1631,79.0,79.0,79.0,1,1,3,0,5
1632,94.0,92.7,87.0,1,8,1,0,10
1635,91.0,91.0,91.0,1,1,0,0,2
1636,88.0,88.0,88.0,0,2,2,0,4
1641,77.0,83.81818181818181,77.0,1,5,4,1,11
1649,88.0,90.5,88.0,1,3,2,0,6
1652,78.0,85.25,78.0,2,4,1,1,8
1664,96.0,93.71428571428571,90.0,0,4,3,0,7
1668,84.0,88.25,84.0,0,4,4,0,8
1671,87.0,89.0,87.0,1,1,3,0,5
1672,86.0,87.61538461538461,85.0,1,4,8,0,13
1673,82.0,80.71428571428571,79.0,5,2,0,0,7
1674,90.0,90.27272727272727,87.0,2,3,6,0,11
1685,76.0,81.6,76.0,2,6,2,0,10
1687,85.0,87.75,85.0,1,0,3,0,4
1692,83.0,83.71428571428571,81.0,2,7,5,0,14
1700,91.0,92.0,89.0,2,4,0,0,6
1702,73.0,77.33333333333333,73.0,1,5,6,0,12
1710,91.0,91.75,90.0,1,5,2,0,8
1712,91.5,91.5,87.0,1,7,0,0,8
1724,83.0,81.85,77.0,2,8,10,0,20
1726,92.0,92.0,92.0,0,12,0,0,12
1727,91.0,90.375,87.0,2,2,4,0,8
1734,81.0,80.0909090909091,70.0,4,11,6,1,22
1741,92.0,91.2,90.0,0,7,3,0,10
1742,83.0,86.0,83.0,1,2,4,0,7
1754,88.0,88.0,86.0,0,10,4,0,14
1757,85.0,83.8125,81.0,2,11,3,0,16
1764,86.0,88.66666666666667,86.0,0,2,4,0,6
1768,90.5,91.625,88.0,1,3,3,1,8
1777,81.0,81.0,81.0,1,4,1,0,6
1778,92.5,92.5,91.0,1,2,1,0,4
1784,90.0,91.25,90.0,0,4,3,1,8
1788,92.0,89.85714285714286,87.0,1,5,1,0,7
1791,88.0,88.3529411764706,86.0,0,13,4,0,17
1792,90.0,90.0,88.0,0,6,3,0,9
1796,81.0,80.66666666666667,80.0,2,10,6,0,18
1797,86.0,86.5,85.0,1,13,2,0,16
1798,97.0,97.0,96.0,0,1,1,0,2
1800,85.0,85.0,84.0,0,5,5,0,10
1811,92.0,91.66666666666667,87.0,1,4,4,0,9
1813,85.0,83.7,78.0,3,1,6,0,10
1815,100.0,100.0,100.0,0,0,0,1,1
1829,82.0,85.5,82.0,2,0,2,0,4
1830,81.0,81.0,80.0,2,4,4,0,10
1831,84.0,85.0,81.0,2,3,5,0,10
1832,84.0,79.10526315789474,71.0,1,10,8,0,19
1837,88.0,83.66666666666667,77.0,2,4,6,0,12
1843,78.0,74.70588235294117,71.0,1,10,6,0,17
1844,88.0,88.0,88.0,0,0,3,0,3
1850,84.0,85.0,82.0,0,7,7,0,14
1852,88.0,88.46153846153847,86.0,0,9,4,0,13
1854,87.0,85.0909090909091,81.0,2,4,5,0,11
1867,89.0,88.9,88.0,1,5,4,0,10
1870,86.0,81.73333333333333,74.0,2,7,6,0,15
1880,88.0,88.85714285714286,88.0,0,3,4,0,7
1894,90.0,90.75,90.0,1,1,2,0,4
1896,84.0,84.0,83.0,2,3,3,0,8
1912,88.0,88.85714285714286,88.0,0,3,4,0,7
1921,79.0,79.0,79.0,1,1,3,0,5
1922,86.0,84.47058823529412,76.0,2,8,7,0,17
1926,86.0,86.58823529411765,84.0,1,10,6,0,17
1927,94.5,94.5,93.0,1,0,1,0,2
1930,86.0,85.625,83.0,3,8,5,0,16
1931,79.0,82.71428571428571,79.0,1,1,5,0,7
1932,80.0,80.85714285714286,77.0,3,6,5,0,14
1939,98.0,97.2,96.0,0,5,0,0,5
1950,90.0,90.8,90.0,0,1,4,0,5
1952,94.0,92.28571428571429,90.0,0,3,4,0,7
1954,88.0,89.84615384615384,88.0,0,6,7,0,13
1959,79.0,82.55555555555556,79.0,2,4,3,0,9
1963,92.0,93.0,92.0,0,2,2,0,4
1968,90.0,90.0,90.0,0,1,2,0,3
1970,86.0,83.73333333333333,79.0,1,8,6,0,15
1972,90.0,90.0,88.0,0,6,2,0,8
1973,83.0,78.625,69.0,4,9,3,0,16
1977,92.5,92.5,91.0,1,2,1,0,4
1978,75.0,75.77777777777777,72.0,5,7,6,0,18
1983,94.0,94.66666666666667,94.0,0,4,2,0,6
1989,87.0,88.5,87.0,2,1,1,0,4
1991,81.0,83.22222222222223,81.0,1,3,5,0,9
1994,90.0,88.6,85.0,1,5,4,0,10
2002,90.0,90.71428571428571,89.0,1,4,2,0,7
2004,69.0,75.8,69.0,3,2,5,0,10
2008,88.0,88.6470588235294,85.0,1,14,2,0,17
2016,91.0,91.66666666666667,91.0,2,1,0,0,3
2017,84.0,86.6,84.0,1,4,5,0,10
2020,74.0,77.71428571428571,74.0,2,2,2,1,7
2031,83.0,81.5,76.0,3,7,4,0,14
2032,87.0,87.5,85.0,2,1,5,0,8
2039,92.5,92.5,91.0,1,2,1,0,4
2044,92.5,93.0,89.0,1,1,2,0,4
2050,91.0,93.33333333333333,91.0,1,2,0,0,3
2051,87.0,85.8,83.0,3,4,3,0,10
2053,96.0,96.0,96.0,0,2,0,0,2
2057,85.0,85.0,85.0,1,2,1,0,4
2061,94.0,93.2,89.0,1,1,2,1,5
2063,80.5,80.33333333333333,74.0,3,13,8,0,24
2066,88.0,86.26666666666667,82.0,0,11,4,0,15
2070,86.0,86.0,86.0,0,1,3,0,4
2072,100.0,100.0,100.0,0,0,0,1,1
2077,83.0,86.25,83.0,1,7,0,0,8
2085,78.0,74.44444444444444,65.0,5,8,5,0,18
2094,96.0,97.0,96.0,0,2,0,2,4
2106,94.0,95.2,94.0,0,2,2,1,5
2109,86.0,84.55555555555556,77.0,1,9,8,0,18
2110,81.0,82.6086956521739,74.0,4,12,7,0,23
2117,90.0,91.5,90.0,0,1,3,0,4
2124,94.0,94.66666666666667,94.0,0,1,2,0,3
2127,79.0,76.23076923076923,73.0,4,8,1,0,13
2131,92.0,92.0,92.0,0,2,1,0,3
2132,85.0,88.0,85.0,1,2,1,1,5
2134,87.0,88.0,87.0,2,3,4,0,9
2135,84.0,87.0909090909091,84.0,0,3,7,1,11
2136,99.0,99.0,98.0,0,1,0,1,2
2143,89.5,89.5,87.0,1,3,2,0,6
2144,92.0,92.0,92.0,0,2,3,0,5
2145,85.5,85.5,84.0,1,3,4,0,8
2152,89.0,89.0,89.0,1,0,1,0,2
2156,94.0,92.85714285714286,90.0,0,4,3,0,7
2168,92.0,92.5,90.0,0,10,2,0,12
2172,83.0,83.0,83.0,1,1,2,0,4
2175,100.0,100.0,100.0,0,0,0,3,3
2189,68.0,71.85714285714286,68.0,3,5,6,0,14
2218,91.0,94.0,91.0,1,2,0,0,3
2223,83.0,84.0,80.0,3,6,4,0,13
2233,87.0,85.5,81.0,2,6,4,0,12
2234,79.0,78.6086956521739,72.0,5,12,6,0,23
2240,85.0,83.85714285714286,79.0,2,8,4,0,14
2243,90.0,90.4,90.0,1,2,2,0,5
2244,96.0,96.66666666666667,96.0,0,3,0,0,3
2245,97.0,97.0,96.0,0,1,1,0,2
2249,88.0,88.0,88.0,0,4,4,0,8
2252,84.0,88.5,84.0,0,4,4,0,8
2256,88.0,89.125,87.0,2,6,0,0,8
2261,100.0,100.0,100.0,0,0,0,3,3
2262,96.0,97.2,96.0,0,3,1,1,5
2263,68.0,68.41379310344827,65.0,9,11,9,0,29
2274,94.0,94.0,92.0,0,4,2,0,6
2279,90.0,91.38461538461539,90.0,0,10,3,0,13
2280,73.0,77.44444444444444,73.0,4,2,3,0,9
2292,79.0,80.25,76.0,3,7,6,0,16
2293,92.0,92.33333333333333,90.0,0,2,4,0,6
2299,97.0,97.5,96.0,0,3,0,1,4
2305,88.0,88.0,85.0,1,4,5,0,10
2315,81.0,84.28571428571429,80.0,3,3,8,0,14
2317,92.0,91.25,90.0,0,3,5,0,8
2323,90.0,90.6,90.0,0,6,4,0,10
2325,84.0,80.94117647058823,72.0,2,9,6,0,17
2326,74.0,72.8,68.0,6,3,6,0,15
2334,81.0,84.11111111111111,81.0,1,4,4,0,9
2335,90.0,91.125,89.0,1,5,2,0,8
2336,86.0,87.5,86.0,0,6,6,0,12
2337,92.0,90.15384615384616,86.0,0,7,6,0,13
2343,87.0,88.7,87.0,3,5,2,0,10
2347,86.0,82.75,75.0,4,5,7,0,16
2352,90.0,91.45454545454545,90.0,0,7,4,0,11
2356,86.0,86.42857142857143,85.0,1,9,4,0,14
2357,67.0,71.66666666666667,67.0,2,7,6,0,15
2358,87.0,85.28571428571429,81.0,4,6,4,0,14
2359,62.0,71.5625,62.0,3,5,8,0,16
2360,87.0,87.0,87.0,2,4,1,0,7
2369,86.0,86.3076923076923,83.0,1,7,5,0,13
2374,80.0,80.0,80.0,2,1,1,0,4
2384,87.0,88.33333333333333,87.0,2,4,0,0,6
2385,91.0,94.0,91.0,1,1,0,1,3
2397,74.0,74.0,74.0,2,4,1,0,7
2407,90.0,90.0,90.0,0,3,1,0,4
2409,72.0,77.0,72.0,3,2,4,0,9
2418,80.0,79.16666666666667,75.0,4,12,2,0,18
2420,92.0,93.27272727272727,92.0,0,9,2,0,11
2421,86.0,85.88888888888889,85.0,4,3,2,0,9
2426,83.0,85.0,83.0,2,1,3,0,6
2427,87.0,87.66666666666667,87.0,2,3,1,0,6
2428,84.0,85.77777777777777,84.0,0,4,5,0,9
2433,98.0,98.0,98.0,0,2,0,1,3
2437,85.0,84.4,80.0,3,7,10,0,20
2447,90.0,91.0,89.0,1,1,6,0,8
2454,90.0,88.15384615384616,82.0,2,5,6,0,13
2455,95.0,95.5,92.0,0,1,2,1,4
2469,98.0,98.0,98.0,0,2,0,0,2
2472,98.0,97.0,93.0,1,1,0,1,3
2483,94.0,95.2,94.0,0,4,1,0,5
2495,100.0,98.66666666666667,96.0,0,0,1,2,3
2497,90.0,90.0,90.0,0,3,1,0,4
2501,90.0,89.6,86.0,0,5,5,0,10
2505,90.5,91.33333333333333,90.0,1,2,3,0,6
2507,92.0,93.33333333333333,92.0,0,0,3,0,3
2519,90.0,87.73333333333333,82.0,0,7,8,0,15
2523,88.0,88.0,88.0,0,4,4,0,8
2535,90.0,91.2,90.0,0,3,2,0,5
2538,73.0,73.0,73.0,3,1,1,0,5
2542,65.0,65.0,65.0,3,3,2,0,8
2544,80.0,80.29166666666667,76.0,7,11,6,0,24
2548,79.0,81.66666666666667,79.0,2,3,4,0,9
2553,74.0,74.0,74.0,2,0,3,0,5
2555,92.0,89.0,83.0,1,6,3,0,10
2559,90.0,91.6,90.0,0,2,3,0,5
2561,94.0,94.0,94.0,0,1,1,0,2
2578,94.0,96.0,94.0,0,1,1,1,3
2580,90.0,90.46153846153847,88.0,0,7,6,0,13
2589,79.0,83.83333333333333,79.0,2,8,2,0,12
2593,73.0,80.55555555555556,73.0,3,4,2,0,9
2596,86.5,86.5,85.0,1,4,3,0,8
2599,79.0,77.75,74.0,4,5,7,0,16
2601,81.0,82.33333333333333,79.0,2,4,6,0,12
2609,75.0,75.0,75.0,1,5,2,0,8
2610,90.0,90.23076923076923,89.0,1,8,4,0,13
2615,90.0,90.88888888888889,90.0,0,5,4,0,9
2619,82.0,83.0909090909091,82.0,1,7,3,0,11
2620,96.0,96.0,96.0,0,2,0,0,2
2622,64.0,68.8125,64.0,3,6,7,0,16
2632,87.0,87.58333333333333,80.0,3,6,3,0,12
2638,81.0,81.5909090909091,79.0,3,12,7,0,22
2646,88.0,87.28571428571429,84.0,0,9,5,0,14
2648,83.0,84.0,83.0,2,3,7,0,12
2649,76.0,76.0,75.0,4,4,9,0,17
2659,79.0,79.2,77.0,5,16,9,0,30
2664,72.0,72.46153846153847,60.0,5,12,9,0,26
2667,92.0,86.25,78.0,3,6,3,0,12
2676,89.0,91.33333333333333,89.0,1,0,2,0,3
2684,84.0,85.0,83.0,3,9,5,0,17
2689,94.0,94.0,91.0,1,2,2,1,6
2690,90.0,90.0,87.0,3,6,3,0,12
2692,96.0,91.28571428571429,85.0,1,4,2,0,7
2697,75.0,75.0,75.0,3,2,0,0,5
2709,84.0,84.28571428571429,84.0,0,4,2,1,7
2716,87.0,84.9047619047619,78.0,3,11,7,0,21
2717,77.0,77.5909090909091,73.0,7,9,6,0,22
2721,84.0,82.85714285714286,80.0,3,7,4,0,14
2725,94.0,94.4,94.0,0,2,3,0,5
2731,93.0,93.0,93.0,1,0,0,0,1
2733,85.0,88.6,85.0,1,1,3,0,5
2737,90.0,90.5,90.0,0,2,6,0,8
2739,83.0,83.82352941176471,79.0,2,8,7,0,17
2743,87.0,88.63636363636364,84.0,3,5,3,0,11
2749,89.0,87.76470588235294,81.0,3,6,8,0,17
2750,88.0,87.11111111111111,84.0,0,2,7,0,9
2755,88.0,87.45454545454545,85.0,1,5,5,0,11
2756,99.0,99.0,98.0,0,1,0,1,2
2758,90.0,90.85714285714286,90.0,0,5,2,0,7
2759,84.0,84.92307692307692,83.0,1,5,7,0,13
2764,78.0,75.41176470588235,67.0,4,7,6,0,17
2766,81.0,82.19047619047619,80.0,5,14,2,0,21
2768,100.0,100.0,100.0,0,0,0,3,3
2777,93.0,93.0,92.0,0,5,1,0,6
2778,76.0,76.0,76.0,2,3,1,0,6
2785,72.0,73.5,70.0,5,12,5,0,22
2788,92.0,92.0,92.0,0,2,1,0,3
2797,83.5,82.6,74.0,3,6,11,0,20
2798,88.0,88.0,88.0,0,4,4,0,8
2799,96.0,96.66666666666667,96.0,0,3,0,0,3
2805,98.0,98.66666666666667,98.0,0,2,0,1,3
2807,86.0,84.33333333333333,81.0,1,8,6,0,15
2808,74.0,74.47619047619048,70.0,5,12,4,0,21
2810,94.0,95.6,94.0,0,5,0,0,5
2818,93.0,93.33333333333333,90.0,0,4,2,0,6
2826,90.0,90.0,90.0,0,1,2,0,3
2829,96.0,96.0,96.0,0,2,0,0,2
2836,92.0,92.72727272727273,92.0,0,8,3,0,11
2837,89.0,91.0,89.0,1,3,1,0,5
2840,92.5,94.83333333333333,92.0,1,2,1,2,6
2841,94.0,92.125,87.0,1,3,3,1,8
2842,73.0,71.61538461538461,70.0,3,2,8,0,13
2843,79.5,81.41666666666667,72.0,3,2,6,1,12
2849,90.0,90.0,90.0,0,2,4,0,6
2854,82.0,84.66666666666667,82.0,0,3,6,0,9
2858,87.0,87.0,87.0,1,1,1,0,3
2863,88.0,87.66666666666667,85.0,1,8,3,0,12
2866,88.5,88.5,85.0,1,2,3,0,6
2869,96.0,96.5,94.0,0,2,1,1,4
2871,94.0,94.8,94.0,0,3,2,0,5
2884,100.0,98.66666666666667,96.0,0,0,1,2,3
2893,88.0,88.4,86.0,0,4,6,0,10
2898,94.0,94.33333333333333,94.0,0,4,2,0,6
2899,90.0,91.6,90.0,0,2,3,0,5
2907,83.0,83.0,80.0,3,3,6,0,12
2917,92.0,91.66666666666667,89.0,1,2,3,0,6
2919,94.0,95.33333333333333,94.0,0,2,1,0,3
2920,96.0,97.0,96.0,0,2,1,1,4
2922,76.0,80.44444444444444,76.0,4,2,3,0,9
2924,82.0,86.0,82.0,0,7,3,0,10
2925,89.0,89.5,88.0,1,6,3,0,10
2926,82.0,85.0,82.0,0,7,3,0,10
2928,94.0,94.0,91.0,1,2,1,1,5
2929,98.0,98.0,98.0,0,1,0,0,1
2933,83.0,83.57142857142857,79.0,2,7,5,0,14
2934,88.0,89.0,85.0,1,3,5,0,9
2941,88.0,88.0,87.0,2,3,1,0,6
2942,88.0,89.6,88.0,0,2,3,0,5
2945,80.0,84.0,80.0,0,6,7,0,13
2949,90.0,91.33333333333333,90.0,0,4,2,0,6
2957,94.0,96.0,94.0,0,1,1,1,3
2970,96.0,96.66666666666667,96.0,0,3,0,0,3
2971,100.0,100.0,100.0,0,0,0,1,1
2972,81.0,80.55555555555556,80.0,3,3,3,0,9
2974,87.0,90.85714285714286,87.0,1,4,1,1,7
2980,89.0,89.66666666666667,89.0,3,1,2,0,6
2987,93.0,93.0,92.0,0,5,1,0,6
2995,85.0,85.0,85.0,2,2,3,0,7
2996,72.0,77.9090909090909,72.0,3,5,3,0,11
3006,90.0,87.85714285714286,85.0,1,3,3,0,7
3014,73.0,77.63636363636364,73.0,1,5,5,0,11
3016,62.0,68.41379310344827,62.0,9,10,10,0,29
3019,88.0,88.6,88.0,0,3,7,0,10
3025,88.0,84.5,80.0,0,10,6,0,16
3029,61.0,69.0,61.0,4,7,4,0,15
3031,83.0,84.71428571428571,79.0,2,7,5,0,14
3032,98.0,98.66666666666667,98.0,0,2,0,1,3
3038,79.0,79.0,79.0,1,1,3,0,5
3043,87.0,87.0,87.0,1,1,1,0,3
3046,82.0,87.2,82.0,0,6,4,0,10
3048,83.0,81.58333333333333,76.0,3,4,5,0,12
3050,90.0,90.0,90.0,0,1,2,1,4
3053,90.0,90.0,90.0,0,1,2,0,3
3054,96.0,94.8,91.0,1,3,0,1,5
3055,88.0,87.125,83.0,2,10,4,0,16
3056,92.0,90.66666666666667,88.0,0,5,4,0,9
3061,99.0,99.0,98.0,0,1,0,1,2
3065,85.0,85.72727272727273,85.0,3,5,3,0,11
3070,76.0,76.86363636363636,74.0,5,6,11,0,22
3072,87.0,87.4,84.0,0,3,7,0,10
3073,87.0,87.0,87.0,1,1,1,0,3
3076,78.0,80.4,78.0,0,1,9,0,10
3082,83.0,82.66666666666667,78.0,3,4,5,0,12
3084,88.0,88.0,88.0,0,2,2,0,4
3090,87.0,87.6,85.0,2,4,4,0,10
3091,92.0,94.66666666666667,92.0,0,0,2,1,3
3102,82.0,82.0,82.0,0,1,4,0,5
3111,89.5,90.5,87.0,1,5,1,1,8
3112,80.0,77.95,69.0,7,10,3,0,20
3114,82.0,84.4,79.0,3,6,6,0,15
3115,72.0,72.0,72.0,2,3,2,0,7
3120,85.0,84.8,83.0,3,2,5,0,10
3121,83.0,83.0,80.0,2,2,4,0,8
3122,81.0,82.41176470588235,79.0,4,6,7,0,17
3129,98.0,98.0,96.0,0,0,1,1,2
3133,85.0,85.0,85.0,1,0,2,0,3
3134,83.0,84.1,81.0,2,4,4,0,10
3151,76.0,69.77777777777777,62.0,4,11,3,0,18
3155,94.0,94.0,94.0,0,2,2,0,4
3165,83.0,81.0,77.0,3,5,6,0,14
3167,76.0,68.38095238095238,59.0,7,9,5,0,21
3183,91.0,92.0,89.0,2,3,1,0,6
3185,85.0,85.0,85.0,1,2,1,0,4
3186,98.0,98.0,96.0,0,2,1,1,4
3189,88.5,89.0,87.0,2,5,5,0,12
3190,81.0,77.76470588235294,70.0,3,10,4,0,17
3196,90.0,91.25,89.0,1,5,2,0,8
3200,82.0,83.72727272727273,81.0,3,3,5,0,11
3206,82.0,80.4,72.0,3,7,10,0,20
3207,100.0,100.0,100.0,0,0,0,2,2
3210,96.0,96.8,96.0,0,4,1,0,5
3211,86.0,87.0,85.0,1,6,5,0,12
3217,79.0,78.92857142857143,78.0,5,4,5,0,14
3218,90.0,90.83333333333333,89.0,2,3,1,0,6
3221,85.0,86.76470588235294,85.0,2,11,4,0,17
3222,86.5,86.8,82.0,1,4,5,0,10
3228,86.0,86.0,86.0,0,1,3,0,4
3229,84.0,83.72727272727273,81.0,3,3,5,0,11
3237,74.0,69.45,60.0,7,5,8,0,20
3241,71.0,80.625,71.0,3,3,2,0,8
3248,92.0,90.8,89.0,1,2,2,0,5
3252,90.0,89.77777777777777,86.0,2,5,2,0,9
3253,92.0,91.0909090909091,87.0,1,9,1,0,11
3256,92.0,90.625,87.0,1,4,3,0,8
3260,96.0,95.6,94.0,0,4,1,0,5
3262,90.0,84.33333333333333,77.0,1,11,3,0,15
3263,94.0,94.8,94.0,0,5,0,0,5
3267,85.0,86.15384615384616,83.0,2,7,4,0,13
3272,91.0,91.0,90.0,0,3,3,0,6
3280,82.0,84.0,82.0,0,3,6,0,9
3285,77.0,80.33333333333333,76.0,4,9,8,0,21
3286,87.0,84.5,81.0,3,6,3,0,12
3300,86.0,87.2,85.0,1,4,5,0,10
3302,90.0,90.8,90.0,0,1,4,0,5
3304,83.0,77.53333333333333,69.0,5,7,3,0,15
3309,81.0,77.61904761904762,67.0,5,9,7,0,21
3317,80.0,81.33333333333333,80.0,2,4,3,0,9
3323,96.0,96.66666666666667,96.0,0,3,0,0,3
3324,89.0,90.16666666666667,87.0,2,3,1,0,6
3328,92.0,88.57142857142857,82.0,2,3,2,0,7
3331,94.0,94.0,94.0,0,2,2,0,4
3335,85.0,84.23076923076923,82.0,1,4,8,0,13
3338,92.0,92.0,92.0,0,2,1,0,3
3343,92.0,90.42857142857143,87.0,1,3,3,0,7
3345,80.0,79.53846153846153,79.0,1,7,5,0,13
3350,96.0,96.0,96.0,0,0,2,0,2
3373,82.0,82.26666666666667,75.0,3,8,4,0,15
3374,84.0,82.0,74.0,2,6,4,2,14
3392,89.5,89.5,85.0,1,4,3,0,8
3393,92.0,93.6,92.0,0,2,3,0,5
3394,90.0,90.125,89.0,1,3,4,0,8
3397,83.0,86.66666666666667,83.0,1,2,3,0,6
3403,89.0,89.0,89.0,1,0,1,0,2
3405,87.5,87.5,85.0,1,1,4,0,6
3409,77.0,80.19047619047619,74.0,4,9,7,1,21
3414,98.0,98.0,98.0,0,1,0,0,1
3420,98.0,98.0,98.0,0,1,0,0,1
3424,88.0,91.2,88.0,0,2,3,0,5
3428,100.0,100.0,100.0,0,0,0,2,2
3429,92.0,92.8,90.0,0,8,2,0,10
3431,94.0,94.0,94.0,0,3,0,0,3
3433,90.0,89.11111111111111,86.0,2,4,3,0,9
3437,87.0,88.0,86.0,3,3,2,0,8
3439,93.0,93.0,91.0,1,4,2,1,8
3440,90.0,91.5,90.0,0,1,3,0,4
3443,94.0,91.81818181818181,88.0,0,7,4,0,11
3444,90.0,89.8,88.0,0,5,5,0,10
3446,98.0,98.0,96.0,0,1,1,1,3
3456,71.0,74.18181818181819,71.0,5,4,2,0,11
3458,96.0,96.0,96.0,0,2,0,0,2
3459,86.0,87.9090909090909,85.0,1,5,5,0,11
3476,90.0,90.4,88.0,0,7,3,0,10
3478,92.0,92.66666666666667,90.0,0,3,3,0,6
3481,86.0,86.0,86.0,0,1,3,0,4
3482,84.5,85.5,79.0,2,5,4,1,12
3484,92.0,89.375,85.0,1,2,5,0,8
3485,90.0,88.6,85.0,1,5,4,0,10
3490,81.0,86.66666666666667,81.0,1,0,4,1,6
3491,90.0,89.77777777777777,88.0,0,5,4,0,9
3492,92.0,93.33333333333333,92.0,0,2,3,1,6
3495,84.0,87.45454545454545,84.0,0,8,3,0,11
3496,92.0,93.8,92.0,1,2,1,1,5
3497,96.0,96.0,96.0,0,2,1,0,3
3498,98.0,98.0,96.0,0,1,1,1,3
3503,100.0,100.0,100.0,0,0,0,3,3
3510,68.0,72.23076923076923,68.0,3,4,6,0,13
3515,92.0,92.33333333333333,92.0,1,0,2,0,3
3518,100.0,100.0,100.0,0,0,0,2,2
3519,100.0,100.0,100.0,0,0,0,2,2
3520,90.0,92.5,90.0,0,1,2,1,4
3522,78.0,79.78947368421052,74.0,5,9,5,0,19
3524,98.0,98.0,98.0,0,1,0,0,1
3525,94.0,96.0,94.0,0,1,1,1,3
3529,72.0,77.0,72.0,3,4,4,0,11
3538,86.0,86.0,86.0,0,1,3,0,4
3543,83.0,80.46153846153847,74.0,3,4,6,0,13
3547,91.0,91.5,90.0,0,4,4,0,8
3550,68.0,73.33333333333333,68.0,0,8,7,0,15
3557,89.0,88.625,87.0,2,2,4,0,8
3561,77.0,75.26666666666667,67.0,4,5,6,0,15
3566,89.0,89.0,89.0,1,0,1,0,2
3571,74.0,79.38461538461539,74.0,0,7,6,0,13
3578,96.0,96.5,96.0,0,3,1,0,4
3586,87.0,86.63636363636364,83.0,2,5,4,0,11
3587,77.0,78.2,77.0,3,3,4,0,10
3591,79.0,78.54545454545455,78.0,3,5,3,0,11
3594,90.0,90.0,90.0,0,3,1,0,4
3595,92.0,93.6,92.0,0,2,3,0,5
3599,87.0,87.0,87.0,1,1,1,0,3
3607,96.0,97.0,96.0,0,2,1,1,4
3611,92.0,91.14285714285714,86.0,2,3,2,0,7
3613,68.0,74.0,68.0,2,7,3,0,12
3614,81.0,80.46153846153847,76.0,4,4,5,0,13
3615,89.0,91.33333333333333,89.0,1,0,2,0,3
3616,87.0,87.0,87.0,1,1,1,0,3
3621,86.0,85.9090909090909,85.0,2,4,5,0,11
3623,85.0,84.71428571428571,81.0,2,9,3,0,14
3626,90.0,90.66666666666667,89.0,1,1,4,0,6
3630,90.0,90.66666666666667,90.0,0,3,3,0,6
3631,90.0,90.0,90.0,0,3,1,0,4
3640,83.0,86.0,83.0,1,1,4,0,6
3642,92.0,92.14285714285714,92.0,1,4,2,0,7
3643,86.0,85.66666666666667,83.0,1,4,7,0,12
3645,90.0,90.0,90.0,0,3,1,0,4
3649,92.0,88.44444444444444,82.0,2,3,3,1,9
3651,90.0,85.66666666666667,77.0,3,7,2,0,12
3655,97.0,97.0,96.0,0,4,0,0,4
3659,92.0,94.0,92.0,0,1,2,0,3
3661,80.0,79.52631578947368,74.0,3,7,9,0,19
3665,88.0,89.6,88.0,0,2,3,0,5
3674,70.0,80.16666666666667,70.0,2,2,8,0,12
3676,70.0,70.0,70.0,4,1,0,0,5
3677,90.0,90.88888888888889,90.0,0,5,4,0,9
3678,95.0,95.0,94.0,0,3,1,0,4
3690,93.0,93.0,93.0,1,0,0,0,1
3707,93.5,93.5,91.0,1,3,0,0,4
3715,82.0,87.27272727272727,82.0,0,7,4,0,11
3727,88.0,88.0,88.0,0,0,3,0,3
3728,92.0,92.8,92.0,0,3,2,0,5
3736,96.0,94.85714285714286,92.0,0,6,1,0,7
3738,91.0,91.0,87.0,2,4,3,0,9
3739,79.0,82.16666666666667,79.0,1,2,3,0,6
3743,83.0,85.625,83.0,1,4,3,0,8
3752,92.0,92.0,92.0,0,2,1,0,3
3769,97.0,97.5,96.0,0,3,0,1,4
3794,85.0,88.75,85.0,1,0,2,1,4
3795,100.0,99.33333333333333,98.0,0,1,0,2,3
3796,90.0,90.125,87.0,1,4,2,1,8
3800,88.0,89.125,87.0,1,3,3,1,8
3803,90.0,92.5,90.0,0,1,2,1,4
3816,67.0,74.27272727272727,67.0,4,5,2,0,11
3817,88.0,85.66666666666667,71.0,0,9,5,1,15
3819,87.0,88.8,87.0,1,3,1,0,5
3825,88.5,88.5,87.0,1,2,3,0,6
3834,90.0,88.71428571428571,87.0,1,4,2,0,7
3838,72.0,78.0,72.0,2,6,3,1,12
3839,81.0,83.4,81.0,2,7,1,0,10
3846,88.5,88.5,87.0,1,2,3,0,6
3850,88.0,88.14285714285714,87.0,2,7,5,0,14
3855,94.0,94.8,94.0,0,3,2,0,5
3858,92.0,92.66666666666667,92.0,0,5,1,0,6
3859,81.0,85.0,81.0,1,5,3,0,9
3861,83.0,83.47058823529412,81.0,4,8,5,0,17
3862,66.0,67.92,65.0,6,11,8,0,25
3867,81.0,81.0,81.0,1,0,3,0,4
3868,88.0,88.0,87.0,2,3,1,0,6
3869,89.0,86.27272727272727,80.0,3,8,0,0,11
3870,82.0,82.5,77.0,2,7,9,0,18
3875,84.0,84.0,84.0,0,4,2,0,6
3877,79.0,79.0,79.0,1,1,3,0,5
3885,86.0,86.0,86.0,0,1,3,0,4
3892,80.0,80.81818181818181,79.0,6,2,3,0,11
3895,82.0,80.66666666666667,76.0,2,10,6,0,18
3899,94.0,94.0,94.0,0,1,1,0,2
3902,97.0,97.0,94.0,0,1,1,2,4
3920,94.0,93.25,91.0,1,7,0,0,8
3924,82.0,84.88888888888889,82.0,2,2,5,0,9
3926,90.0,89.5,88.0,1,2,5,0,8
3929,89.0,89.0,89.0,1,2,0,0,3
3935,98.0,98.0,96.0,0,1,1,1,3
3936,96.0,95.66666666666667,93.0,1,1,1,0,3
3948,92.0,89.33333333333333,85.0,1,5,3,0,9
3951,77.0,78.63636363636364,76.0,5,11,6,0,22
3953,73.0,73.0,73.0,1,4,3,0,8
3959,100.0,100.0,100.0,0,0,0,2,2
3960,94.5,94.5,93.0,1,0,1,0,2
3962,90.0,92.4,90.0,0,3,2,0,5
3963,76.0,82.75,76.0,2,4,2,0,8
3972,96.0,96.0,96.0,0,0,2,0,2
3982,94.0,90.44444444444444,86.0,0,5,4,0,9
4025,89.0,89.0,88.0,0,5,3,0,8
4037,90.0,91.6,90.0,0,4,1,0,5
4056,100.0,100.0,100.0,0,0,0,2,2
4057,94.0,95.33333333333333,94.0,0,2,1,0,3
4068,92.0,93.0,92.0,0,2,2,0,4
4072,98.0,98.0,98.0,0,1,0,0,1
4078,98.0,98.0,96.0,0,0,1,1,2
4108,88.0,89.71428571428571,88.0,0,4,3,0,7
4145,94.0,92.8,91.0,1,4,0,0,5
4152,87.0,89.8,87.0,1,2,2,0,5
4171,86.5,86.5,85.0,1,4,3,0,8
4184,94.0,93.71428571428571,92.0,0,5,2,0,7
4186,,,,0,2,2,0,4
4209,98.0,98.66666666666667,98.0,0,1,0,2,3
4231,92.0,92.0,92.0,0,4,0,0,4
4323,94.0,94.8,94.0,0,5,0,0,5
4335,82.5,82.5,82.0,3,3,2,0,8
4400,92.0,93.33333333333333,92.0,0,0,3,0,3
4412,92.0,90.8,89.0,1,2,2,0,5
4416,94.0,95.33333333333333,94.0,0,2,1,0,3
4421,88.0,88.0,86.0,0,8,5,0,13
4434,94.5,94.5,89.0,1,0,1,2,4
4438,100.0,98.66666666666667,96.0,0,0,1,2,3
4449,82.5,81.8,80.0,4,10,6,0,20
4465,92.0,92.25,90.0,0,6,2,0,8
4469,92.0,92.33333333333333,90.0,0,2,4,0,6
4474,96.0,96.0,96.0,0,0,3,0,3
4475,96.0,94.8,91.0,1,3,0,1,5
4476,100.0,98.66666666666667,96.0,0,0,1,2,3
4478,99.0,98.5,96.0,0,1,1,2,4
4479,79.0,83.875,79.0,1,3,4,0,8
4480,98.0,97.6,96.0,0,4,0,1,5
4481,93.0,91.8,89.0,2,1,2,0,5
4483,92.0,91.25,90.0,0,3,5,0,8
4492,86.5,86.9,81.0,1,5,4,0,10
4495,90.0,94.0,90.0,0,1,2,2,5
4500,85.0,89.0,85.0,1,3,2,0,6
4502,77.0,79.3076923076923,77.0,1,7,5,0,13
4509,92.0,92.4,89.0,1,0,3,1,5
4519,96.0,96.0,96.0,0,0,2,0,2
4531,92.0,92.0,92.0,0,4,2,0,6
4533,79.0,78.96153846153847,74.0,2,16,8,0,26
4535,96.0,97.0,96.0,0,2,1,1,4
4538,94.0,93.25,90.0,0,4,4,0,8
4539,92.0,94.0,92.0,0,2,1,1,4
4542,91.0,94.0,91.0,1,1,0,1,3
4544,93.0,93.33333333333333,92.0,0,3,3,0,6
4553,92.0,93.5,92.0,0,3,1,0,4
4555,94.0,94.0,94.0,0,3,0,0,3
4558,88.0,87.66666666666667,86.0,4,5,3,0,12
4559,81.0,83.28571428571429,81.0,2,2,3,0,7
4584,94.0,93.8,92.0,0,9,1,0,10
4590,91.0,89.875,87.0,2,4,2,0,8
4592,92.0,92.8,92.0,0,3,2,0,5
4593,97.0,97.0,96.0,0,4,0,0,4
4594,90.0,92.0,90.0,0,2,2,0,4
4598,90.0,88.63636363636364,85.0,1,6,4,0,11
4607,84.0,83.52941176470588,82.0,1,11,5,0,17
4608,84.0,84.33333333333333,76.0,2,8,2,0,12
4610,92.0,93.6,92.0,0,4,1,0,5
4614,75.0,76.84615384615384,75.0,2,6,5,0,13
4618,98.0,98.0,96.0,0,2,0,2,4
4620,91.0,91.0,90.0,0,3,3,0,6
4621,72.0,72.0,72.0,2,1,3,0,6
4622,86.0,86.9090909090909,86.0,0,9,2,0,11
4623,99.0,99.0,98.0,0,1,0,1,2
4627,90.0,91.2,90.0,0,3,2,0,5
4630,98.0,98.0,96.0,0,2,0,2,4
4634,99.0,99.0,98.0,0,1,0,1,2
4636,94.0,94.0,92.0,0,6,2,1,9
4638,98.0,98.0,96.0,0,0,1,1,2
4643,81.0,81.9090909090909,81.0,2,7,2,0,11
4650,84.0,86.33333333333333,84.0,0,3,3,0,6
4654,90.0,90.4,88.0,0,6,4,0,10
4656,96.0,96.0,96.0,0,6,0,0,6
4665,94.0,94.66666666666667,94.0,0,4,2,0,6
4667,100.0,100.0,100.0,0,0,0,2,2
4670,81.0,82.36363636363636,81.0,1,6,4,0,11
4671,98.0,98.66666666666667,98.0,0,2,0,1,3
4672,84.0,86.0,84.0,2,7,3,0,12
4678,83.0,81.58823529411765,75.0,2,10,5,0,17
4683,92.0,90.66666666666667,88.0,0,6,3,0,9
4685,96.0,92.44444444444444,87.0,1,7,0,1,9
4686,94.0,93.14285714285714,92.0,0,4,3,0,7
4692,98.0,98.0,98.0,0,1,0,0,1
4694,94.0,92.85714285714286,90.0,0,4,3,0,7
4700,90.0,91.71428571428571,90.0,0,4,3,0,7
4702,94.0,94.66666666666667,94.0,0,1,2,0,3
4703,85.5,85.78571428571429,84.0,1,9,4,0,14
4705,83.0,83.0,83.0,1,3,1,0,5
4706,90.0,90.0,90.0,0,1,2,1,4
4708,94.0,93.75,92.0,0,7,1,0,8
4716,88.0,87.57142857142857,87.0,1,3,3,0,7
4718,85.0,85.0,83.0,3,3,4,0,10
4729,89.0,86.18181818181819,81.0,2,6,3,0,11
4732,90.0,89.05882352941177,83.0,1,11,4,1,17
4734,88.0,86.66666666666667,85.0,1,6,2,0,9
4746,79.0,80.2,79.0,3,3,3,1,10
4753,88.0,92.28571428571429,88.0,0,6,1,0,7
4754,90.0,93.14285714285714,90.0,0,5,1,1,7
4755,90.0,90.4,86.0,0,8,2,0,10
4762,92.0,92.36363636363636,90.0,0,9,2,0,11
4774,76.0,79.11111111111111,76.0,3,2,4,0,9
4777,91.0,91.0,90.0,0,3,3,0,6
4782,78.0,77.55555555555556,77.0,5,3,1,0,9
4787,86.0,84.5,82.0,2,3,3,0,8
4794,80.0,80.22222222222223,71.0,6,9,3,0,18
4797,90.0,89.6923076923077,86.0,0,6,7,0,13
4798,84.0,84.0,84.0,0,6,5,0,11
4800,98.0,98.0,98.0,0,3,0,1,4
4801,96.0,96.0,94.0,0,3,1,0,4
4803,74.0,76.0,73.0,3,9,8,0,20
4804,90.0,89.0909090909091,86.0,0,6,5,0,11
4806,94.0,94.0,94.0,0,5,2,0,7
4817,90.0,91.33333333333333,90.0,0,4,2,0,6
4819,88.0,91.25,88.0,0,7,1,0,8
4824,94.0,93.66666666666667,93.0,1,1,1,0,3
4828,94.0,94.66666666666667,94.0,0,1,2,0,3
4837,93.0,93.0,93.0,1,0,0,0,1
4841,100.0,100.0,100.0,0,0,0,2,2
4842,90.0,93.6,90.0,0,2,2,1,5
4843,100.0,100.0,100.0,0,0,0,2,2
4844,94.0,94.0,94.0,0,2,2,0,4
4846,78.0,82.38461538461539,78.0,1,4,8,0,13
4850,94.0,94.0,90.0,0,4,2,0,6
4859,90.0,89.81818181818181,88.0,0,7,4,0,11
4860,90.0,90.28571428571429,88.0,0,9,5,0,14
4864,78.0,79.9,76.0,5,8,7,0,20
4868,90.0,91.5,90.0,1,3,2,0,6
4874,87.0,87.0,86.0,1,4,6,0,11
4893,91.0,91.0,90.0,0,3,3,0,6
4894,86.0,86.0,85.0,2,5,1,0,8
4896,96.0,96.0,96.0,0,4,1,0,5
4900,94.0,94.0,94.0,0,1,1,0,2
4906,94.0,94.0,94.0,0,2,2,0,4
4907,81.0,80.76470588235294,80.0,3,10,4,0,17
4914,96.0,96.0,96.0,0,0,1,0,1
4917,69.0,69.0,69.0,1,4,4,0,9
4920,96.0,96.0,96.0,0,2,2,0,4
4922,89.0,89.45454545454545,87.0,2,6,3,0,11
4923,86.0,87.92307692307692,85.0,1,5,7,0,13
4935,85.0,85.5,81.0,3,5,4,0,12
4944,92.0,93.33333333333333,92.0,0,0,3,0,3
4947,100.0,100.0,100.0,0,0,0,1,1
4952,96.0,97.6,96.0,0,2,1,2,5
4957,92.0,92.0,92.0,0,4,0,0,4
4959,86.0,87.0,85.0,2,7,6,0,15
4963,78.0,80.22222222222223,78.0,3,3,3,0,9
4978,70.0,76.5,70.0,2,0,6,0,8
4982,94.0,94.33333333333333,92.0,0,5,1,0,6
4986,88.0,88.6,88.0,0,3,7,0,10
4987,86.0,88.5,86.0,1,3,3,1,8
5000,90.0,92.85714285714286,90.0,0,6,1,0,7
5006,90.0,90.66666666666667,88.0,0,0,6,0,6
5010,94.0,91.2,86.0,2,1,2,0,5
5011,96.0,96.5,96.0,0,3,1,0,4
5016,88.0,84.35714285714286,78.0,2,7,4,1,14
5017,77.0,79.1875,75.0,4,7,5,0,16
5019,98.0,98.0,98.0,0,3,0,0,3
5025,90.0,91.5,90.0,0,8,4,0,12
5032,94.0,95.2,94.0,0,2,2,1,5
5033,86.0,87.23529411764706,83.0,1,13,3,0,17
5038,89.0,89.0,89.0,1,2,0,0,3
5039,86.0,89.33333333333333,86.0,0,3,3,0,6
5053,92.0,93.0,92.0,0,2,2,0,4
5071,93.0,93.33333333333333,90.0,0,4,2,0,6
5074,90.0,92.0,89.0,1,4,4,0,9
5077,92.0,93.0,92.0,0,2,2,0,4
5083,90.0,90.0,90.0,0,6,2,0,8
5096,94.0,92.28571428571429,90.0,0,3,4,0,7
5104,99.0,99.0,98.0,0,1,0,1,2
5118,97.0,97.0,96.0,0,4,0,0,4
5124,96.0,95.33333333333333,94.0,0,5,1,0,6
5129,90.0,89.1,85.0,1,5,4,0,10
5136,94.0,95.0,94.0,0,4,0,0,4
5144,90.0,90.85714285714286,90.0,0,5,2,0,7
5150,94.0,94.0,94.0,0,1,1,0,2
5156,91.0,88.9090909090909,84.0,1,5,5,0,11
5168,89.0,89.0,89.0,1,1,2,0,4
5170,94.0,94.0,94.0,0,1,1,0,2
5171,100.0,100.0,100.0,0,0,0,2,2
5175,98.0,98.0,98.0,0,1,0,0,1
5177,94.0,94.0,94.0,0,1,1,0,2
5179,90.5,90.5,89.0,1,4,1,0,6
5180,85.0,89.71428571428571,85.0,1,3,2,1,7
5183,90.0,89.6,89.0,1,1,3,0,5
5185,98.0,98.0,96.0,0,1,1,1,3
5191,96.0,96.0,96.0,0,2,0,0,2
5192,91.0,92.66666666666667,91.0,1,1,1,0,3
5194,90.5,91.33333333333333,90.0,1,2,3,0,6
5196,87.0,87.8,87.0,2,1,2,0,5
5206,91.0,90.57142857142857,88.0,1,2,4,0,7
5209,98.0,98.0,96.0,0,0,1,1,2
5210,94.0,94.0,94.0,0,1,1,0,2
5211,92.0,94.8,92.0,0,3,1,1,5
5212,85.0,86.11111111111111,84.0,1,0,8,0,9
5213,100.0,100.0,100.0,0,0,0,1,1
5214,100.0,100.0,100.0,0,0,0,1,1
5215,87.0,88.25,86.0,0,2,6,0,8
5221,81.0,83.83333333333333,81.0,1,3,2,0,6
5225,100.0,100.0,100.0,0,0,0,2,2
5226,100.0,100.0,100.0,0,0,0,1,1
5227,76.0,80.44444444444444,76.0,0,4,5,0,9
5232,100.0,100.0,100.0,0,0,0,2,2
5243,92.0,94.66666666666667,92.0,0,0,2,1,3
5252,88.0,88.0,84.0,2,3,1,0,6
5254,94.0,95.0,92.0,0,0,3,1,4
5257,87.0,85.45454545454545,82.0,2,5,4,0,11
5258,88.0,88.18181818181819,86.0,0,6,5,0,11
5267,96.0,96.66666666666667,96.0,0,3,0,0,3
5268,94.0,95.25,93.0,1,1,1,1,4
5271,97.0,97.0,94.0,0,1,1,2,4
5272,100.0,98.66666666666667,96.0,0,0,1,2,3
5278,98.0,98.0,96.0,0,0,1,1,2
5281,79.0,79.66666666666667,79.0,5,1,6,0,12
5289,100.0,100.0,100.0,0,0,0,1,1
5297,94.0,93.66666666666667,93.0,1,1,1,0,3
5301,81.0,84.0,81.0,1,5,3,0,9
5307,97.0,97.5,96.0,0,3,0,1,4
5310,96.0,96.0,96.0,0,6,0,0,6
5312,96.0,97.33333333333333,96.0,0,2,0,1,3
5313,95.0,95.33333333333333,94.0,0,6,0,0,6
5325,94.0,95.33333333333333,94.0,0,2,1,0,3
5409,98.0,98.0,96.0,0,0,1,1,2
5420,100.0,100.0,100.0,0,0,0,1,1
5430,100.0,100.0,100.0,0,0,0,2,2
5434,100.0,99.33333333333333,98.0,0,1,0,2,3
5441,100.0,100.0,100.0,0,0,0,1,1
5463,95.5,95.5,93.0,1,1,0,0,2
5521,100.0,94.42857142857143,87.0,1,1,1,4,7
5524,100.0,99.6,98.0,0,0,0,5,5
5528,100.0,100.0,100.0,0,0,0,5,5
5530,91.0,91.0,91.0,1,1,0,0,2
5533,92.0,94.66666666666667,92.0,0,0,2,1,3
5544,100.0,99.6,98.0,0,1,0,4,5
5552,90.0,92.5,90.0,0,1,2,1,4
5562,100.0,100.0,100.0,0,2,1,0,3
5578,94.0,94.0,94.0,0,1,1,0,2
5605,100.0,99.33333333333333,98.0,0,1,0,2,3
5606,94.0,94.0,94.0,0,1,1,0,2
5607,87.0,90.25,87.0,1,1,1,1,4
5619,90.0,90.0,90.0,0,1,2,0,3
5634,92.0,94.4,92.0,0,4,1,0,5
5653,94.0,95.2,94.0,0,4,1,0,5
5654,96.0,96.0,96.0,0,4,1,0,5
5744,100.0,100.0,100.0,0,0,0,2,2
5760,94.0,94.8,94.0,2,5,5,0,12
5770,90.0,90.0,90.0,0,1,2,0,3
5786,94.0,94.0,94.0,0,1,1,0,2
5787,100.0,100.0,100.0,0,0,0,5,5
5788,100.0,100.0,100.0,0,0,0,5,5
5789,100.0,100.0,100.0,0,0,0,5,5
5790,100.0,100.0,100.0,0,0,0,5,5
5791,100.0,100.0,100.0,0,0,0,5,5
5792,100.0,100.0,100.0,0,0,0,5,5
5794,100.0,100.0,100.0,0,0,0,5,5
5796,94.0,92.8,87.0,1,7,0,2,10
5797,98.0,96.25,92.0,0,5,1,2,8
5800,100.0,98.2,93.0,1,1,0,3,5
5801,100.0,98.85714285714286,96.0,0,2,1,4,7
5802,98.0,97.14285714285714,94.0,0,3,2,2,7
5803,94.0,95.14285714285714,92.0,0,2,4,1,7
5804,100.0,100.0,100.0,0,0,0,6,6
5805,90.0,90.81818181818181,87.0,1,3,7,0,11
5807,94.0,95.11111111111111,92.0,0,6,2,1,9
5808,100.0,97.42857142857143,92.0,0,1,2,4,7
5810,92.0,92.8,89.0,2,2,5,1,10
5811,96.0,97.2,96.0,0,4,1,1,6
5812,100.0,99.2,98.0,0,2,0,3,5
5813,98.0,97.33333333333333,94.0,0,1,2,3,6
5814,100.0,99.6,98.0,0,1,0,4,5
5815,96.0,96.4,93.0,2,0,1,2,5
5816,100.0,99.0,96.0,0,1,1,4,6
5817,94.0,94.66666666666667,92.0,0,4,4,1,9
5818,100.0,97.42857142857143,91.0,1,1,0,5,7
5819,100.0,98.85714285714286,96.0,0,2,0,5,7
5820,96.0,96.0,91.0,1,4,0,2,7
5821,100.0,98.57142857142857,96.0,0,3,0,4,7
5823,98.0,95.875,89.0,2,0,2,4,8
5825,99.0,99.0,98.0,0,3,0,3,6
5827,96.0,94.0,88.0,0,1,5,2,8
5828,96.0,96.0,94.0,0,4,3,2,9
5829,100.0,98.28571428571429,94.0,0,1,1,5,7
5830,100.0,99.0,96.0,0,1,1,4,6
5831,100.0,99.33333333333333,96.0,0,0,1,5,6
5833,96.0,95.71428571428571,92.0,0,1,5,1,7
5834,98.0,97.71428571428571,94.0,0,3,1,3,7
5835,97.0,97.16666666666667,93.0,1,1,2,2,6
5837,100.0,97.0,91.0,1,1,0,4,6
5838,97.0,95.875,91.0,2,3,1,2,8
5839,100.0,99.2,96.0,0,0,1,4,5
5841,96.0,97.11111111111111,94.0,0,5,0,4,9
5842,96.0,96.8,96.0,0,4,1,0,5
5843,100.0,99.33333333333333,96.0,0,0,1,5,6
5844,93.5,94.75,91.0,2,3,1,2,8
5847,93.5,92.3,90.0,1,7,2,0,10
5848,100.0,99.0,96.0,0,1,1,4,6
5849,100.0,99.33333333333333,96.0,0,0,1,5,6
5850,98.0,98.4,96.0,0,2,1,2,5
5851,98.0,98.28571428571429,96.0,0,4,0,3,7
5852,100.0,99.33333333333333,96.0,0,0,1,5,6
5853,95.0,96.0,94.0,0,4,3,1,8
5854,92.0,93.0,89.0,1,8,4,0,13
5855,90.0,94.0,88.0,0,3,4,6,13
5856,98.0,98.0,96.0,0,4,0,2,6
5858,100.0,98.83333333333333,93.0,1,0,0,5,6
5859,94.0,94.18181818181819,91.0,1,7,2,1,11
5860,100.0,100.0,100.0,0,0,0,6,6
5862,98.0,96.57142857142857,91.0,1,2,1,3,7
5864,100.0,99.66666666666667,98.0,0,1,0,5,6
5865,98.0,97.71428571428571,96.0,0,4,1,2,7
5866,96.0,96.0,92.0,0,0,5,2,7
5867,100.0,98.66666666666667,96.0,0,0,2,4,6
5868,99.0,97.83333333333333,93.0,1,1,1,3,6
5869,99.0,98.66666666666667,96.0,0,2,1,3,6
5870,94.0,94.75,90.0,0,2,3,3,8
5871,100.0,100.0,100.0,0,0,0,6,6
5872,99.0,98.66666666666667,96.0,0,2,1,3,6
5874,96.0,94.8,91.0,1,1,2,1,5
5875,94.0,94.4,91.0,1,6,3,0,10
5877,100.0,98.57142857142857,96.0,0,3,0,4,7
5880,96.0,95.77777777777777,94.0,0,9,0,0,9
5881,98.0,97.2,94.0,0,2,1,2,5
5883,100.0,99.2,98.0,0,2,0,3,5
5884,96.5,96.125,92.0,1,2,1,4,8
5885,100.0,100.0,100.0,0,0,0,5,5
5886,98.0,98.0,96.0,0,0,1,1,2
5888,100.0,99.33333333333333,96.0,0,0,1,5,6
5889,96.0,96.85714285714286,94.0,0,2,3,2,7
5891,100.0,95.71428571428571,90.0,0,1,2,4,7
5892,100.0,98.57142857142857,96.0,0,3,0,4,7
5893,100.0,98.16666666666667,93.0,1,0,1,4,6
5894,100.0,99.66666666666667,98.0,0,1,0,5,6
5895,98.0,97.14285714285714,94.0,0,3,2,2,7
5897,96.0,95.6,91.0,1,1,1,2,5
5898,100.0,99.66666666666667,98.0,0,1,0,5,6
5901,100.0,100.0,100.0,0,0,0,3,3
5902,99.0,97.83333333333333,93.0,1,1,1,3,6
5903,100.0,98.4,96.0,0,0,2,3,5
5905,92.0,90.52941176470588,86.0,1,12,4,0,17
5907,100.0,99.33333333333333,96.0,0,0,1,5,6
5908,92.0,91.45454545454545,88.0,0,7,4,0,11
5912,100.0,98.16666666666667,93.0,1,0,1,4,6
5913,88.0,92.0,88.0,0,2,2,2,6
5915,94.0,95.33333333333333,94.0,0,6,2,2,10
5919,98.0,97.71428571428571,96.0,0,4,1,2,7
5925,90.0,92.5,90.0,0,7,4,1,12
5926,96.0,95.66666666666667,93.0,2,2,2,0,6
5927,94.0,93.8,89.0,1,2,5,2,10
5935,100.0,100.0,100.0,0,0,0,4,4
5938,91.0,92.875,87.0,2,2,1,3,8
5940,73.0,80.14285714285714,73.0,3,5,6,0,14
5942,96.0,97.2,96.0,0,4,3,1,8
5946,92.0,94.0,92.0,0,5,0,1,6
5948,95.0,96.0,94.0,0,1,3,2,6
5950,93.0,95.0,92.0,2,0,2,2,6
5952,98.0,96.0,92.0,0,2,2,1,5
5953,100.0,99.0,96.0,0,2,0,6,8
5955,96.0,96.0,92.0,0,6,2,2,10
5958,93.5,94.0,89.0,1,1,1,1,4
5959,96.0,96.5,94.0,0,4,2,2,8
5960,91.0,92.28571428571429,88.0,1,1,3,2,7
5961,96.0,97.6,96.0,0,0,3,2,5
5962,95.0,96.0,94.0,0,2,4,2,8
5963,98.0,94.625,87.0,1,3,1,3,8
5966,94.0,96.28571428571429,94.0,0,3,2,2,7
5968,100.0,100.0,100.0,0,0,0,3,3
5970,100.0,97.6,94.0,0,1,1,3,5
5973,91.0,91.0,91.0,1,1,0,0,2
5974,97.0,97.5,96.0,0,3,0,1,4
5975,98.0,98.0,98.0,0,2,0,0,2
5977,100.0,100.0,100.0,0,0,0,3,3
5980,100.0,98.66666666666667,96.0,0,0,1,2,3
5982,96.0,96.0,96.0,0,0,2,0,2
5985,100.0,99.33333333333333,98.0,0,1,0,2,3
5986,96.0,96.0,96.0,0,2,1,0,3
5988,94.0,93.6,92.0,0,1,4,0,5
5990,93.5,94.5,91.0,1,1,1,1,4
5992,93.5,94.0,89.0,1,1,1,1,4
5993,91.0,91.0,91.0,2,2,0,0,4
5995,98.0,98.0,96.0,0,1,1,1,3
5997,98.0,98.0,96.0,0,2,1,1,4
5998,86.0,89.28571428571429,86.0,1,2,4,0,7
5999,90.0,91.0,90.0,0,3,5,0,8
6000,96.0,96.33333333333333,94.0,0,4,1,1,6
6001,100.0,100.0,100.0,0,0,0,1,1
6003,92.5,92.5,89.0,1,0,3,0,4
6005,94.0,94.66666666666667,94.0,0,1,2,0,3
6007,94.0,94.0,92.0,0,3,4,0,7
6009,98.0,98.0,96.0,0,0,2,2,4
6010,96.0,96.8,96.0,0,4,0,1,5
6012,100.0,100.0,100.0,0,0,0,2,2
6015,98.0,98.0,96.0,0,1,1,1,3
6016,93.0,95.33333333333333,93.0,2,0,0,1,3
6017,98.0,98.66666666666667,98.0,0,2,0,1,3
6018,98.0,98.0,96.0,0,0,1,1,2
6019,100.0,99.0,96.0,0,0,1,3,4
6021,100.0,98.66666666666667,96.0,0,0,1,2,3
6025,90.0,88.92307692307692,85.0,1,6,6,0,13
6030,99.0,99.0,98.0,0,1,0,1,2
6032,92.0,94.66666666666667,92.0,0,0,2,1,3
6037,100.0,100.0,100.0,0,0,0,1,1
6086,94.0,96.0,94.0,0,1,1,1,3
6348,100.0,99.0,96.0,0,0,1,3,4
6356,98.0,98.0,96.0,0,1,1,1,3
6432,94.0,93.66666666666667,91.0,1,4,1,0,6
6500,87.0,87.4,84.0,0,3,7,0,10
6521,92.0,94.0,92.0,0,3,2,0,5
6564,82.0,81.53846153846153,77.0,1,4,8,0,13
6619,86.0,84.35,73.0,2,13,5,0,20
6620,82.5,82.5,77.0,1,4,5,0,10
6625,96.0,97.33333333333333,96.0,0,2,0,1,3
6636,88.0,88.92307692307692,88.0,0,10,3,0,13
6640,92.0,92.0,92.0,0,2,1,0,3
6654,81.0,79.0909090909091,74.0,1,15,6,0,22
6660,86.0,86.5,83.0,1,6,5,0,12
6677,92.0,92.85714285714286,92.0,0,7,0,0,7
6686,100.0,100.0,100.0,0,0,0,2,2
6718,86.0,86.0,85.0,2,5,1,0,8
6729,82.0,82.0,82.0,0,5,2,0,7
6734,84.0,84.0,84.0,0,4,2,0,6
6739,86.0,85.125,84.0,0,10,6,0,16
6748,100.0,100.0,100.0,0,0,0,2,2
6756,96.0,95.42857142857143,92.0,0,4,1,2,7
6768,88.0,87.875,87.0,2,1,5,0,8
6800,91.0,90.625,87.0,2,5,1,0,8
6802,100.0,100.0,100.0,0,0,0,3,3
6813,98.0,98.0,98.0,0,1,0,0,1
6860,92.0,92.0,92.0,0,2,1,0,3
6863,90.0,89.0909090909091,86.0,0,6,5,0,11
6864,90.0,91.5,90.0,0,1,3,0,4
6904,96.0,96.8,96.0,0,4,0,1,5
6913,89.0,91.25,89.0,1,3,0,0,4
6916,77.0,78.66666666666667,77.0,2,6,4,0,12
6944,90.0,90.0,90.0,0,3,1,0,4
6948,86.0,88.25,86.0,0,5,3,0,8
6962,88.0,80.1875,69.0,3,10,3,0,16
6965,79.0,79.26666666666667,75.0,2,3,10,0,15
6966,79.0,85.44444444444444,79.0,1,4,4,0,9
7024,86.0,88.0,86.0,0,1,5,0,6
7033,90.5,91.5,87.0,1,2,2,1,6
7055,76.0,77.85714285714286,75.0,5,2,7,0,14
7087,87.0,88.0909090909091,87.0,2,7,2,0,11
7095,93.0,93.0,92.0,0,5,1,0,6
7105,94.0,94.66666666666667,94.0,0,1,2,0,3
7111,98.0,98.0,98.0,0,1,0,0,1
7112,100.0,100.0,100.0,0,0,0,2,2
7119,72.0,72.0,72.0,2,3,2,0,7
7206,96.0,97.33333333333333,96.0,0,0,2,1,3
7207,82.0,85.75,82.0,0,3,5,0,8
7210,96.0,96.66666666666667,96.0,0,3,0,0,3
7211,88.0,88.36363636363636,86.0,0,5,6,0,11
7214,87.0,89.91666666666667,87.0,2,8,2,0,12
7216,75.0,74.66666666666667,73.0,2,7,12,0,21
7241,96.0,97.0,96.0,0,2,1,1,4
7243,82.0,79.53333333333333,75.0,4,6,5,0,15
7275,97.0,97.0,96.0,0,4,0,0,4
7276,82.0,85.81818181818181,82.0,1,7,3,0,11
7366,96.0,96.66666666666667,96.0,0,3,0,0,3
7375,91.0,94.0,91.0,1,1,0,1,3
7394,88.0,83.41176470588235,73.0,1,6,10,0,17
7405,85.0,86.6,85.0,2,0,3,0,5
7407,92.0,93.6,92.0,0,4,1,0,5
7456,94.0,96.0,94.0,0,1,1,1,3
7457,95.0,95.0,94.0,0,1,3,0,4
7461,98.0,98.0,98.0,0,2,0,0,2
7467,89.0,90.25,88.0,0,3,4,1,8
7471,99.0,99.0,98.0,0,1,0,1,2
7475,96.0,96.0,96.0,0,2,1,0,3
7477,97.0,97.5,96.0,0,3,0,1,4
7479,80.0,83.7,80.0,1,2,7,0,10
7480,90.0,92.0,90.0,0,4,3,0,7
7488,86.0,89.42857142857143,86.0,0,4,3,0,7
7489,86.0,84.72222222222223,77.0,1,12,5,0,18
7491,80.0,86.22222222222223,80.0,3,4,1,1,9
7493,85.0,87.55,84.0,1,13,6,0,20
7495,98.0,98.0,96.0,0,2,0,2,4
7496,96.0,96.0,96.0,0,0,1,0,1
7503,92.0,94.66666666666667,92.0,0,0,3,0,3
7512,86.0,86.52941176470588,85.0,2,10,5,0,17
7517,100.0,100.0,100.0,0,0,0,4,4
7519,98.0,98.0,96.0,0,0,1,1,2
7525,99.0,99.0,98.0,0,1,0,1,2
7527,94.0,94.66666666666667,94.0,0,4,2,0,6
7528,96.0,96.66666666666667,96.0,0,3,0,0,3
7529,94.0,96.0,94.0,0,4,0,1,5
7534,94.0,94.33333333333333,92.0,0,5,1,0,6
7537,80.5,79.94444444444444,76.0,6,5,7,0,18
7538,94.0,94.0,92.0,0,2,2,0,4
7546,92.0,94.66666666666667,92.0,0,0,2,1,3
7547,90.0,93.0,90.0,0,4,1,1,6
7558,92.0,90.92857142857143,87.0,1,11,2,0,14
7573,90.0,92.0,90.0,0,2,2,0,4
7575,88.0,87.8125,85.0,1,9,6,0,16
7576,100.0,100.0,100.0,0,0,0,2,2
7598,94.0,94.0,94.0,0,2,2,0,4
7599,99.0,99.0,98.0,0,1,0,1,2
7600,98.0,98.0,98.0,0,1,0,0,1
7601,100.0,99.33333333333333,98.0,0,1,0,2,3
7602,94.0,96.0,94.0,0,1,1,1,3
7603,96.0,96.25,93.0,1,2,0,1,4
7605,92.0,92.0,92.0,0,0,2,0,2
7610,98.0,98.0,98.0,0,3,0,0,3
7634,100.0,100.0,100.0,0,0,0,1,1
7635,92.0,91.2,90.0,0,7,3,0,10
7636,79.5,79.5,78.0,3,4,3,0,10
7640,98.0,98.0,96.0,0,0,1,1,2
7641,94.0,91.875,87.0,1,6,1,0,8
7643,78.0,73.28571428571429,67.0,3,5,6,0,14
7645,86.0,87.33333333333333,86.0,0,11,7,0,18
7646,96.0,96.0,94.0,0,3,2,0,5
7649,96.0,95.11111111111111,92.0,0,7,0,2,9
7651,100.0,100.0,100.0,0,0,0,1,1
7652,95.0,96.0,94.0,0,1,2,1,4
7653,94.0,94.8,94.0,0,3,2,0,5
7655,94.0,94.0,94.0,0,6,0,0,6
7661,87.0,86.9,83.0,2,4,4,0,10
7663,94.0,92.76923076923077,90.0,0,12,1,0,13
7664,94.5,95.0,93.0,2,1,1,0,4
7675,92.0,92.0,92.0,0,0,2,0,2
7678,90.0,87.11111111111111,83.0,2,3,4,0,9
7689,96.0,97.33333333333333,96.0,0,0,2,1,3
7691,92.5,93.16666666666667,89.0,1,4,0,1,6
7711,74.0,76.72727272727273,72.0,5,8,9,0,22
7718,91.0,91.0,91.0,1,1,0,0,2
7722,99.0,99.0,98.0,0,1,0,1,2
7728,100.0,100.0,100.0,0,0,0,2,2
7729,92.0,92.0,92.0,0,0,2,0,2
7738,78.0,78.0,78.0,0,3,4,0,7
7744,96.0,96.0,96.0,0,0,1,0,1
7745,94.0,93.71428571428571,92.0,0,6,1,0,7
7747,83.0,84.0,81.0,2,9,4,0,15
7748,90.0,90.5,90.0,0,2,6,0,8
7755,92.0,92.0,92.0,0,6,1,0,7
7757,92.0,91.5,86.0,3,7,0,0,10
7759,90.5,90.5,89.0,1,4,1,0,6
7761,90.0,88.83333333333333,86.0,0,8,4,0,12
7762,83.0,83.0,83.0,1,3,1,0,5
7764,90.0,91.57142857142857,90.0,1,4,2,0,7
7765,94.0,93.33333333333333,92.0,0,2,4,0,6
7768,90.0,94.0,90.0,0,1,2,2,5
7772,88.0,88.42105263157895,84.0,0,16,3,0,19
7778,91.0,91.0,91.0,1,1,0,0,2
7779,96.0,94.66666666666667,92.0,0,6,3,0,9
7786,87.5,88.33333333333333,85.0,2,5,5,0,12
7856,84.0,87.0,84.0,0,4,4,0,8
7857,95.0,95.5,92.0,0,1,2,1,4
7880,94.0,94.66666666666667,94.0,0,1,2,0,3
7997,94.0,93.33333333333333,92.0,0,2,4,0,6
8122,97.0,97.0,96.0,0,1,1,0,2
8151,96.0,96.0,96.0,0,0,1,0,1
8249,92.0,92.0,92.0,0,0,2,0,2
8251,100.0,99.33333333333333,98.0,0,1,0,2,3
8750,91.0,91.0,89.0,2,4,1,0,7
8821,93.0,93.0,92.0,0,1,3,0,4
8823,100.0,100.0,100.0,0,0,0,2,2
8847,83.0,87.71428571428571,83.0,1,4,2,0,7
8882,87.0,90.25,87.0,1,1,1,1,4
8948,88.0,88.85714285714286,88.0,0,3,4,0,7
9103,88.5,88.5,88.0,1,2,3,0,6
9155,92.0,94.4,92.0,0,4,1,0,5
9156,67.0,74.63636363636364,67.0,3,4,4,0,11
9164,90.0,90.85714285714286,90.0,0,5,2,0,7
9208,89.0,89.66666666666667,84.0,2,3,1,0,6
9232,86.0,85.38461538461539,80.0,2,7,4,0,13
9248,96.0,97.33333333333333,96.0,0,2,0,1,3
9273,85.0,81.875,76.0,4,10,2,0,16
9283,83.0,81.66666666666667,80.0,3,4,2,0,9
9298,87.0,87.36363636363636,86.0,1,5,5,0,11
9310,89.0,90.66666666666667,89.0,2,1,3,0,6
9359,96.0,96.0,96.0,0,0,1,0,1
9444,92.0,91.6,91.0,1,3,1,0,5
9599,87.0,89.25,87.0,1,1,2,0,4
9631,88.0,88.33333333333333,85.0,1,8,3,0,12
9652,79.5,80.16666666666667,74.0,4,4,4,0,12
9672,100.0,100.0,100.0,0,0,0,3,3
9677,89.0,89.0,89.0,1,0,1,0,2
9679,63.0,67.52941176470588,63.0,5,10,2,0,17
9684,85.0,87.33333333333333,82.0,3,10,2,0,15
9710,96.0,96.0,96.0,0,2,0,0,2
9745,98.0,96.4,94.0,0,4,1,0,5
9765,92.0,94.0,92.0,0,2,1,1,4
9797,98.0,98.0,96.0,0,0,1,1,2
9869,94.0,94.66666666666667,94.0,0,1,2,0,3
9948,88.0,86.4,80.0,2,3,5,0,10
10030,98.0,97.4,93.0,1,1,1,2,5
10083,81.0,83.22222222222223,81.0,1,3,5,0,9
10127,96.0,96.0,96.0,0,0,1,0,1
10131,92.0,91.6,91.0,1,3,1,0,5
10170,82.0,82.0,82.0,2,0,1,0,3
10235,89.0,88.75,88.0,1,2,0,1,4
10280,88.0,86.58823529411765,81.0,1,9,7,0,17
10282,92.0,92.85714285714286,91.0,1,5,1,0,7
10332,79.0,77.82352941176471,75.0,4,8,5,0,17
10377,93.0,95.0,93.0,2,0,1,2,5
10433,86.0,82.18181818181819,70.0,2,16,4,0,22
10438,92.0,91.33333333333333,90.0,0,5,4,0,9
10540,79.5,79.5,72.0,4,7,3,0,14
10625,79.0,81.72727272727273,79.0,2,7,2,0,11
10668,96.0,96.0,96.0,0,2,0,0,2
10875,91.0,91.0,90.0,0,3,3,0,6
10877,48.0,56.68421052631579,48.0,3,7,9,0,19
10931,93.5,93.5,91.0,1,3,0,0,4
10990,86.0,85.28571428571429,84.0,0,6,8,0,14
11034,72.0,72.0,72.0,2,1,3,0,6
11289,90.0,90.0,90.0,0,1,2,0,3
11304,88.0,90.66666666666667,88.0,0,4,2,0,6
11365,97.0,97.0,96.0,0,1,1,0,2
11379,79.0,79.0,79.0,1,3,2,0,6
11487,92.0,94.57142857142857,91.0,1,1,3,2,7
11488,100.0,99.0,96.0,0,0,1,3,4
11491,96.5,96.5,93.0,1,0,0,1,2
11568,86.0,86.375,86.0,1,4,3,0,8
11594,90.0,91.5,90.0,0,1,3,0,4
11610,88.5,89.83333333333333,87.0,1,1,3,1,6
11860,82.5,84.07142857142857,80.0,1,10,3,0,14
12005,98.0,98.0,98.0,0,2,0,0,2
12083,83.0,83.0,83.0,2,2,4,0,8
12682,85.0,85.0,85.0,1,2,1,0,4
12768,92.0,91.14285714285714,90.0,0,5,2,0,7
12788,96.0,96.0,96.0,0,0,1,0,1
12970,97.0,92.25,82.0,2,2,2,2,8
13041,92.0,92.25,92.0,1,2,1,0,4
13218,87.5,87.5,85.0,1,1,4,0,6
13226,98.0,98.0,98.0,0,1,0,0,1
13374,99.0,99.0,98.0,0,3,0,3,6
13426,96.0,94.28571428571429,92.0,0,6,1,0,7
13427,96.0,96.5,94.0,0,2,1,1,4
13428,90.0,90.0,90.0,0,3,1,0,4
13623,83.0,82.6923076923077,75.0,4,6,3,0,13
13671,89.0,89.0,89.0,2,0,2,0,4
13814,88.0,87.57142857142857,87.0,1,3,3,0,7
13831,81.0,81.0,79.0,2,4,4,0,10
13838,90.0,90.0,90.0,0,2,4,0,6
14005,90.0,90.0,90.0,0,5,5,0,10
14071,85.0,88.0,85.0,1,4,2,0,7
14075,96.0,96.0,96.0,0,0,1,0,1
14285,83.0,80.77777777777777,78.0,3,3,3,0,9
14303,84.0,84.0,84.0,0,2,3,0,5
14429,100.0,100.0,100.0,0,0,0,1,1
14525,100.0,100.0,100.0,0,0,0,1,1
14577,79.0,79.0,79.0,1,3,2,0,6
14688,89.0,91.33333333333333,89.0,1,0,2,0,3
14740,98.0,98.5,98.0,0,3,0,1,4
14743,98.0,98.0,96.0,0,3,0,2,5
14909,96.0,96.5,94.0,0,2,1,1,4
14910,98.0,97.0,93.0,1,1,0,1,3
14971,100.0,99.6,98.0,0,1,0,4,5
15120,92.0,91.71428571428571,89.0,1,3,3,0,7
15279,92.0,89.0,83.0,1,6,3,0,10
15535,92.5,94.5,92.0,1,3,1,1,6
15738,75.0,79.0909090909091,75.0,3,2,5,1,11
15752,98.0,98.0,96.0,0,0,1,1,2
15806,97.0,97.5,96.0,0,3,0,1,4
16047,92.0,92.71428571428571,92.0,1,5,1,0,7
16286,88.0,90.0,88.0,0,3,3,0,6
16329,80.0,73.21052631578948,64.0,3,6,10,0,19
16349,91.0,91.11111111111111,88.0,0,15,3,0,18
16424,92.0,92.44444444444444,92.0,0,7,2,0,9
16432,100.0,100.0,100.0,0,0,0,3,3
16441,75.0,76.25,74.0,4,7,13,0,24
16513,83.0,82.38461538461539,81.0,3,4,6,0,13
16751,88.0,88.8,84.0,0,6,4,0,10
16784,89.0,91.33333333333333,89.0,1,0,2,0,3
17346,99.0,99.0,98.0,0,1,0,1,2
17508,89.0,92.66666666666667,89.0,1,0,1,1,3
17570,84.0,84.0,84.0,0,2,3,0,5
17612,97.0,97.0,94.0,0,1,1,2,4
17616,85.0,87.2,85.0,1,2,2,0,5
17647,88.0,88.85714285714286,88.0,0,3,4,0,7
17689,74.0,75.17647058823529,70.0,4,5,8,0,17
17723,69.0,75.0,69.0,1,8,6,0,15
17750,81.0,80.55555555555556,80.0,3,3,3,0,9
17762,88.0,87.25,82.0,0,11,5,0,16
17779,90.0,90.85714285714286,90.0,0,5,2,0,7
17822,96.0,96.66666666666667,96.0,0,3,0,0,3
17933,96.0,97.33333333333333,96.0,0,2,0,1,3
17947,81.0,79.0,71.0,5,3,5,0,13
18047,75.0,75.1923076923077,72.0,3,8,15,0,26
18102,86.0,81.61538461538461,71.0,3,5,5,0,13
18120,88.0,87.6,83.0,1,5,4,0,10
18126,93.0,93.0,93.0,1,0,0,0,1
18268,100.0,100.0,100.0,0,0,0,1,1
18310,82.0,80.93333333333334,78.0,3,6,6,0,15
18357,86.0,86.0,86.0,0,3,2,0,5
18399,100.0,100.0,100.0,0,0,0,1,1
18462,90.0,92.8,90.0,0,2,3,0,5
18480,70.0,70.36363636363636,68.0,6,9,7,0,22
18514,73.0,76.18181818181819,72.0,5,5,12,0,22
18538,88.0,90.0,88.0,0,3,2,0,5
18573,91.5,91.75,89.0,2,4,2,0,8
18577,92.0,91.6,89.0,1,0,4,0,5
18606,83.5,83.5,83.0,1,5,4,0,10
18616,86.0,86.42857142857143,86.0,1,2,4,0,7
18755,92.0,92.0,92.0,0,0,2,0,2
18767,90.0,88.83333333333333,86.0,0,8,4,0,12
18800,83.0,86.0,83.0,1,1,4,0,6
18805,96.0,96.0,96.0,0,0,1,0,1
18825,85.0,84.13333333333334,78.0,3,6,6,0,15
18826,87.0,87.0,87.0,1,1,1,0,3
18855,94.0,94.0,94.0,0,2,2,0,4
18874,96.0,96.0,96.0,0,2,1,0,3
18921,93.0,93.0,93.0,2,0,0,0,2
18940,94.0,94.66666666666667,94.0,0,1,2,0,3
18952,100.0,100.0,100.0,0,0,0,2,2
18953,100.0,100.0,100.0,0,0,0,2,2
18954,100.0,100.0,100.0,0,0,0,2,2
18981,96.0,96.0,96.0,0,2,0,0,2
18996,88.0,91.2,88.0,0,0,5,0,5
19002,87.0,87.33333333333333,86.0,3,4,5,0,12
19003,82.0,72.93333333333334,62.0,7,4,4,0,15
19041,82.0,83.33333333333333,82.0,1,3,5,0,9
19043,88.0,89.61538461538461,87.0,1,7,5,0,13
19055,89.0,90.2,89.0,1,2,2,0,5
19056,96.0,96.0,96.0,0,2,1,0,3
19057,98.0,98.0,96.0,0,0,1,1,2
19058,98.0,98.0,96.0,0,0,1,1,2
19060,94.0,95.33333333333333,94.0,0,2,1,0,3
19061,94.0,94.66666666666667,94.0,0,1,2,0,3
19064,92.0,92.0,92.0,0,0,2,0,2
19076,81.0,76.42857142857143,65.0,6,9,6,0,21
19082,88.0,89.6,88.0,0,0,5,0,5
19094,89.5,89.5,89.0,1,3,2,0,6
19131,83.0,83.0,83.0,1,5,0,0,6
19138,89.0,85.88888888888889,82.0,2,2,5,0,9
19169,88.0,88.0,88.0,0,4,4,0,8
19170,98.0,98.5,98.0,0,3,0,1,4
19171,94.0,94.0,94.0,0,1,1,0,2
19205,92.0,90.625,87.0,1,4,3,0,8
19357,69.0,69.0,69.0,1,6,3,0,10
19373,72.0,70.26470588235294,63.0,9,9,16,0,34
19379,90.0,89.875,89.0,2,4,2,0,8
19403,94.0,94.66666666666667,94.0,0,4,2,0,6
19416,94.0,94.57142857142857,94.0,0,6,1,0,7
19417,96.0,96.4,96.0,0,5,0,0,5
19418,98.0,97.33333333333333,96.0,0,2,1,0,3
20116,88.0,88.45454545454545,87.0,1,6,4,0,11
20291,82.0,84.8,82.0,3,0,2,0,5
20327,83.0,83.42857142857143,83.0,3,2,2,0,7
20367,77.0,77.9375,76.0,4,5,7,0,16
20625,100.0,100.0,100.0,0,0,0,2,2
21101,96.0,96.0,96.0,0,0,1,0,1
21143,90.0,90.0,88.0,0,2,4,0,6
21407,88.0,83.53846153846153,77.0,1,6,6,0,13
21429,96.0,94.4,91.0,1,4,0,0,5
21583,96.0,96.0,96.0,0,0,2,0,2
21785,82.0,83.0,82.0,1,3,5,0,9
21807,85.0,82.84615384615384,75.0,5,3,5,0,13
21909,94.0,93.2,91.0,1,2,2,0,5
21921,77.5,78.625,69.0,1,7,8,0,16
21982,84.0,78.06666666666666,70.0,3,5,7,0,15
22177,90.0,92.0,90.0,0,3,1,1,5
22304,86.0,89.71428571428571,86.0,0,2,5,0,7
22606,86.0,87.46666666666667,83.0,1,7,7,0,15
22671,96.0,96.66666666666667,96.0,0,3,0,0,3
23068,80.0,82.22222222222223,80.0,3,5,1,0,9
23273,94.0,94.28571428571429,94.0,0,3,4,0,7
23557,89.0,89.0,89.0,1,2,0,0,3
23702,76.0,76.0,76.0,2,1,2,0,5
23704,92.0,92.28571428571429,90.0,0,3,3,1,7
23865,90.0,93.6,90.0,0,2,2,1,5
24023,92.0,93.5,92.0,0,3,1,0,4
24024,94.0,96.0,94.0,0,1,1,1,3
24025,90.0,91.6,90.0,0,4,1,0,5
24198,85.0,86.71428571428571,85.0,2,4,1,0,7
24279,87.5,87.5,85.0,1,1,4,0,6
24431,94.0,94.22222222222223,92.0,0,8,1,0,9
24437,95.0,95.0,94.0,0,3,1,0,4
24534,88.5,89.25,88.0,1,2,5,0,8
24572,81.0,77.25,69.0,5,8,3,0,16
25151,95.0,95.5,94.0,0,2,2,0,4
25153,86.0,89.0,86.0,1,4,2,1,8
25160,100.0,100.0,100.0,0,0,0,3,3
25161,94.0,93.71428571428571,92.0,0,5,2,0,7
25162,94.0,94.66666666666667,92.0,0,4,1,1,6
25163,100.0,99.33333333333333,98.0,0,1,0,2,3
25167,91.0,90.42857142857143,89.0,2,3,2,0,7
25301,85.0,84.35714285714286,81.0,2,9,3,0,14
25374,85.0,85.2,85.0,4,4,2,0,10
25404,96.0,96.0,96.0,0,0,1,0,1
25651,88.0,91.6,88.0,0,1,4,0,5
25777,88.5,89.5,85.0,1,4,2,1,8
26025,87.0,87.0,87.0,1,1,1,0,3
26146,100.0,99.33333333333333,98.0,0,1,0,2,3
26149,88.0,88.0,82.0,3,3,5,0,11
26340,75.0,78.63636363636364,75.0,2,5,4,0,11
26341,95.0,95.0,94.0,0,1,3,0,4
26343,90.0,92.4,90.0,0,3,2,0,5
26379,90.0,91.2,90.0,0,3,2,0,5
27055,90.0,93.14285714285714,90.0,0,5,1,1,7
27306,96.0,97.33333333333333,96.0,0,0,2,1,3
27350,83.0,79.76923076923077,75.0,3,2,8,0,13
27472,89.0,90.1,88.0,1,7,2,0,10
27680,84.0,84.0,84.0,0,2,3,0,5
27790,92.5,92.5,89.0,1,0,3,0,4
27791,100.0,98.66666666666667,96.0,0,0,1,2,3
27799,88.0,87.375,84.0,4,7,5,0,16
27801,91.0,91.0,91.0,0,0,0,1,1
27821,96.0,96.0,96.0,0,2,0,0,2
27851,100.0,99.33333333333333,98.0,0,1,0,2,3
27874,98.0,98.0,98.0,0,3,0,0,3
27947,98.0,98.0,96.0,0,0,1,1,2
27949,82.0,77.47368421052632,70.0,2,9,8,0,19
27964,87.0,87.75,83.0,2,3,3,0,8
28044,98.0,98.0,98.0,0,3,0,0,3
28169,90.0,89.27272727272727,88.0,0,6,5,0,11
28206,74.0,82.3076923076923,74.0,2,9,2,0,13
28318,88.0,87.875,87.0,2,1,5,0,8
28468,90.0,91.33333333333333,90.0,0,5,4,0,9
28843,89.0,89.5,88.0,1,6,3,0,10
28976,98.0,96.8,94.0,0,3,1,1,5
29246,87.0,90.0,87.0,1,6,0,0,7
29304,92.0,92.0,92.0,0,2,1,0,3
29312,93.0,93.66666666666667,90.0,0,3,2,1,6
29428,85.0,85.08333333333333,81.0,2,6,4,0,12
29429,87.5,87.5,85.0,1,5,2,0,8
29610,66.0,71.57142857142857,66.0,3,5,6,0,14
29948,71.0,79.66666666666667,71.0,4,0,5,0,9
29950,98.0,97.2,96.0,0,5,0,0,5
29956,90.0,92.4,90.0,0,3,2,0,5
30001,86.0,89.33333333333333,86.0,2,0,1,0,3
30156,100.0,99.2,98.0,0,2,0,3,5
30478,96.0,96.0,96.0,0,2,0,0,2
30496,96.0,96.0,96.0,0,0,1,0,1
30532,78.0,80.83333333333333,78.0,3,7,8,0,18
31568,90.0,86.25,81.0,1,6,5,0,12
32170,88.0,87.375,84.0,1,10,5,0,16
32556,77.0,78.85714285714286,75.0,2,5,7,0,14
32570,86.0,86.71428571428571,82.0,0,8,6,0,14
32578,88.0,89.71428571428571,88.0,0,4,3,0,7
32579,92.5,93.75,92.0,1,1,2,0,4
32586,94.0,94.0,94.0,0,1,1,0,2
32625,89.0,89.4,86.0,0,6,4,0,10
32654,77.0,79.26315789473684,76.0,5,5,9,0,19
32671,75.0,77.70833333333333,70.0,3,10,11,0,24
32698,84.0,84.0,84.0,0,4,2,0,6
32702,86.0,85.4,82.0,2,1,7,0,10
32729,83.0,85.25,83.0,2,5,1,0,8
32733,96.0,96.0,94.0,0,3,3,0,6
32736,90.0,90.66666666666667,90.0,0,4,5,0,9
32738,92.0,92.14285714285714,92.0,1,4,2,0,7
32818,92.0,92.57142857142857,92.0,0,3,4,0,7
32823,94.0,94.66666666666667,94.0,0,5,1,0,6
32835,94.0,94.0,94.0,0,1,1,0,2
32862,92.0,92.0,92.0,0,0,2,0,2
32872,80.0,84.5,80.0,1,6,3,0,10
32887,65.0,67.33333333333333,65.0,5,5,5,0,15
32897,100.0,100.0,100.0,0,0,0,2,2
32919,70.0,72.33333333333333,70.0,3,7,5,0,15
32925,82.0,83.58823529411765,78.0,3,7,7,0,17
33011,96.0,96.5,94.0,0,2,1,1,4
33014,90.0,90.0,90.0,0,1,2,0,3
33054,94.0,94.75,93.0,1,2,1,0,4
33056,85.0,87.33333333333333,85.0,1,2,3,0,6
33084,94.0,92.66666666666667,90.0,0,8,1,0,9
33093,94.0,96.0,94.0,0,1,1,1,3
33096,90.0,90.75,90.0,1,1,2,0,4
33113,88.0,86.66666666666667,82.0,2,4,2,2,10
33125,87.0,82.36363636363636,75.0,4,4,3,0,11
33145,94.0,92.18181818181819,90.0,0,11,0,0,11
33160,91.5,91.5,89.0,1,1,2,0,4
33173,98.0,98.0,98.0,0,3,0,0,3
33198,90.5,91.0,87.0,1,7,0,0,8
33222,90.5,90.5,87.0,1,4,1,0,6
33315,96.0,96.66666666666667,96.0,0,1,2,0,3
33375,83.0,83.0,83.0,1,1,2,0,4
33378,90.0,90.0,90.0,0,1,2,0,3
33379,81.0,81.0,81.0,1,4,1,0,6
33386,92.0,91.55555555555556,90.0,0,6,3,0,9
33388,96.0,97.33333333333333,96.0,0,2,0,1,3
33413,98.0,96.85714285714286,91.0,1,3,0,3,7
33442,83.0,84.08333333333333,82.0,4,6,2,0,12
33448,91.0,88.8,78.0,1,1,2,1,5
33467,94.0,92.5,90.0,0,5,3,0,8
33468,84.0,84.3529411764706,80.0,3,8,6,0,17
33516,90.0,90.0,90.0,0,3,1,0,4
33527,85.0,83.57142857142857,80.0,3,8,3,0,14
33564,94.0,94.0,94.0,0,1,1,0,2
33591,87.0,87.0,87.0,1,1,1,0,3
33619,94.0,94.66666666666667,94.0,0,1,2,0,3
33700,89.0,89.75,87.0,1,5,6,0,12
33709,99.0,99.0,98.0,0,1,0,1,2
33710,96.0,96.0,96.0,0,8,0,0,8
33712,71.0,75.875,71.0,1,11,4,0,16
33747,81.0,82.71428571428571,81.0,2,0,5,0,7
33831,96.0,96.0,96.0,0,0,1,0,1
33837,92.0,92.8,92.0,0,3,2,0,5
33851,69.0,74.71428571428571,69.0,2,8,4,0,14
33865,94.0,93.2,92.0,0,3,2,0,5
33891,92.0,89.66666666666667,85.0,0,0,2,1,3
33911,68.0,77.83333333333333,68.0,3,4,5,0,12
33914,85.0,85.66666666666667,83.0,2,8,2,0,12
33916,85.0,84.45454545454545,82.0,1,1,9,0,11
33920,70.0,76.85714285714286,70.0,2,6,6,0,14
33935,88.0,88.0,85.0,1,8,6,0,15
33940,90.0,90.25,90.0,0,2,2,0,4
33945,90.0,90.625,89.0,1,4,3,0,8
33997,100.0,100.0,100.0,0,0,0,2,2
33999,90.0,88.72727272727273,85.0,1,7,3,0,11
34033,83.0,86.0,83.0,1,2,2,0,5
34046,86.0,90.28571428571429,86.0,0,2,4,1,7
34066,84.0,87.23076923076923,84.0,2,6,5,0,13
34102,88.0,88.85714285714286,88.0,0,3,4,0,7
34181,86.0,87.71428571428571,86.0,0,3,4,0,7
34186,86.0,90.28571428571429,86.0,0,3,4,0,7
34220,96.0,96.0,96.0,0,2,0,0,2
34221,88.0,89.25,87.0,2,4,2,0,8
34222,94.0,95.33333333333333,94.0,0,2,1,0,3
34244,99.0,99.0,98.0,0,1,0,1,2
34352,94.0,94.66666666666667,92.0,0,4,1,1,6
34353,92.0,91.75,90.0,0,4,4,0,8
34387,94.0,94.0,94.0,0,3,0,0,3
34388,75.0,75.0,75.0,3,2,0,0,5
34395,91.0,93.33333333333333,91.0,1,2,0,0,3
34411,90.0,92.66666666666667,90.0,0,5,1,0,6
34418,87.0,88.0,85.0,2,3,4,0,9
34434,85.0,83.875,75.0,4,8,3,1,16
34458,72.0,77.45454545454545,72.0,2,3,6,0,11
34505,79.0,79.0,79.0,1,1,3,0,5
34585,86.0,84.66666666666667,83.0,1,4,4,0,9
34591,90.0,89.66666666666667,86.0,2,6,4,0,12
34611,81.0,79.47619047619048,74.0,3,8,10,0,21
34662,89.0,88.22222222222223,85.0,2,4,3,0,9
34665,83.0,84.14285714285714,81.0,2,8,4,0,14
34676,68.0,68.0,68.0,2,5,2,0,9
34708,90.0,88.46153846153847,82.0,2,8,3,0,13
34710,94.0,94.0,94.0,0,1,1,0,2
34726,92.0,90.375,85.0,1,4,3,0,8
34728,90.0,90.66666666666667,90.0,0,3,3,0,6
34746,92.0,92.0,92.0,0,4,0,0,4
34749,90.0,92.0,90.0,0,2,2,0,4
34787,94.0,94.33333333333333,92.0,0,5,1,0,6
34814,87.0,84.72727272727273,82.0,2,3,6,0,11
34839,79.0,76.47619047619048,67.0,5,8,8,0,21
34858,89.0,89.75,86.0,0,4,4,0,8
34910,88.0,86.0,79.0,1,8,6,0,15
34992,94.0,94.0,94.0,0,1,1,0,2
35106,86.0,88.28571428571429,86.0,0,4,3,0,7
35199,79.0,76.3125,71.0,4,3,9,0,16
35221,79.0,82.66666666666667,79.0,1,4,4,0,9
35240,85.0,85.0,85.0,1,2,1,0,4
35317,90.0,90.85714285714286,90.0,0,5,2,0,7
35340,98.0,96.83333333333333,93.0,1,4,1,0,6
35415,100.0,100.0,100.0,0,0,0,1,1
35425,82.0,83.875,82.0,1,2,5,0,8
35464,92.5,93.5,89.0,1,0,2,1,4
35507,91.0,91.0,90.0,0,3,3,0,6
35565,87.0,89.25,87.0,1,1,2,0,4
35591,89.0,89.0,87.0,2,1,4,0,7
35592,84.0,83.66666666666667,80.0,3,4,5,0,12
35659,81.0,82.0,80.0,4,3,4,0,11
35702,73.0,71.75,61.0,5,12,11,0,28
35771,98.0,98.0,98.0,0,2,0,0,2
35786,92.0,92.66666666666667,92.0,0,7,2,0,9
35790,100.0,100.0,100.0,0,0,0,2,2
35805,83.0,79.85,65.0,4,10,6,0,20
35812,90.0,88.55555555555556,86.0,1,4,4,0,9
35828,76.5,76.5,74.0,3,5,4,0,12
35852,90.0,89.46666666666667,86.0,0,10,5,0,15
35855,88.0,87.88888888888889,87.0,2,3,4,0,9
35862,93.0,86.77777777777777,78.0,3,2,4,0,9
35882,96.0,96.0,96.0,0,4,1,0,5
36014,85.0,86.18181818181819,83.0,2,5,4,0,11
36020,88.0,89.5,88.0,0,6,2,0,8
36022,75.0,78.0,73.0,4,9,5,0,18
36023,92.0,92.0,92.0,0,0,2,0,2
36024,88.0,86.63157894736842,81.0,1,14,4,0,19
36160,92.0,92.5,91.0,1,6,1,0,8
36201,80.0,84.57142857142857,80.0,2,5,0,0,7
36205,88.0,89.0,86.0,0,3,9,0,12
36208,92.0,91.2,90.0,0,7,3,0,10
36213,96.0,97.33333333333333,96.0,0,2,0,1,3
36214,100.0,100.0,100.0,0,0,0,2,2
36215,98.0,98.0,98.0,0,1,0,0,1
36216,100.0,100.0,100.0,0,0,0,2,2
36277,90.0,90.0,90.0,0,4,3,0,7
36348,90.0,86.6,77.0,1,7,7,0,15
36378,92.0,91.71428571428571,90.0,0,3,4,0,7
36396,100.0,100.0,100.0,0,0,0,2,2
36451,96.0,96.0,96.0,0,0,1,0,1
36452,81.0,84.11111111111111,81.0,1,4,4,0,9
36473,92.0,92.6,92.0,0,9,1,0,10
36474,80.0,84.28571428571429,80.0,2,2,3,0,7
36494,94.0,93.2,91.0,1,2,2,0,5
36512,92.5,92.5,91.0,1,2,1,0,4
36513,92.0,92.0,92.0,0,2,1,0,3
36519,85.0,86.6,85.0,2,0,3,0,5
36523,82.0,82.4,82.0,1,4,5,0,10
36534,86.0,90.25,86.0,0,5,2,1,8
36547,99.0,99.0,98.0,0,1,0,1,2
36570,86.0,86.72727272727273,85.0,1,5,5,0,11
36571,85.0,82.45,74.0,5,7,8,0,20
36589,67.0,71.66666666666667,67.0,2,7,6,0,15
36602,82.0,84.66666666666667,82.0,0,2,4,0,6
36614,83.0,83.0,83.0,1,1,2,0,4
36618,91.0,91.0,90.0,0,3,3,0,6
36635,88.0,89.71428571428571,88.0,0,4,3,0,7
36673,89.5,81.05,64.0,5,10,5,0,20
36685,91.0,91.22222222222223,90.0,2,4,3,0,9
36687,83.0,84.38461538461539,80.0,4,4,5,0,13
36695,97.0,97.0,96.0,0,1,1,0,2
36730,92.0,92.0,88.0,0,6,2,0,8
36744,71.0,75.125,71.0,5,0,3,0,8
36745,75.0,76.42857142857143,71.0,7,4,3,0,14
36750,96.0,95.0,93.0,1,2,0,0,3
36758,86.0,86.85714285714286,86.0,1,3,3,0,7
36786,82.0,80.06666666666666,75.0,4,8,3,0,15
36840,82.0,86.0,82.0,4,1,4,0,9
36850,96.0,94.4,91.0,1,4,0,0,5
36861,91.0,93.33333333333333,91.0,1,2,0,0,3
36875,94.0,93.8,93.0,1,2,2,0,5
36876,88.5,88.75,86.0,1,2,5,0,8
36911,92.0,90.42857142857143,87.0,1,2,4,0,7
37038,90.0,91.0,89.0,1,6,2,0,9
37060,85.0,87.45454545454545,85.0,2,7,2,0,11
37090,85.5,81.61111111111111,71.0,4,6,8,0,18
37115,87.0,86.8,83.0,2,5,3,0,10
37151,92.0,92.0,92.0,0,2,1,0,3
37166,90.0,90.66666666666667,88.0,0,0,6,0,6
37167,92.0,94.4,92.0,0,2,2,1,5
37168,80.0,85.16666666666667,80.0,3,2,1,0,6
37169,100.0,100.0,100.0,0,0,0,3,3
37170,98.0,98.0,96.0,0,0,1,1,2
37171,95.0,95.5,92.0,0,1,2,1,4
37231,77.0,72.8125,64.0,6,4,6,0,16
37232,92.5,92.5,91.0,1,2,1,0,4
37234,93.5,94.5,91.0,1,1,1,1,4
37304,76.0,76.375,71.0,6,7,3,0,16
37344,71.0,73.4,71.0,2,7,6,0,15
37350,94.0,94.8,94.0,0,5,0,0,5
37361,98.0,98.0,96.0,0,2,0,2,4
37389,90.0,88.66666666666667,86.0,0,7,5,0,12
37390,78.0,78.0,78.0,2,2,1,0,5
37405,70.0,72.54545454545455,70.0,5,3,3,0,11
37407,78.0,78.23529411764706,77.0,5,9,3,0,17
37462,85.0,85.0,85.0,0,0,0,1,1
37482,85.0,88.0,85.0,1,4,2,0,7
37507,94.0,96.4,94.0,0,3,0,2,5
37575,85.0,85.0,85.0,1,2,1,0,4
37651,87.0,91.14285714285714,87.0,1,6,0,0,7
37654,88.0,90.0,88.0,0,3,2,0,5
37656,96.0,95.5,94.0,0,8,0,0,8
37658,88.5,89.375,88.0,1,4,3,0,8
37670,94.0,94.66666666666667,94.0,0,2,4,0,6
37682,82.0,85.81818181818181,82.0,0,5,5,1,11
37688,96.0,95.14285714285714,94.0,0,7,0,0,7
37717,95.0,95.0,94.0,0,3,1,0,4
37731,88.0,87.76923076923077,87.0,1,9,3,0,13
37732,90.0,93.6,90.0,0,2,2,1,5
37755,90.0,89.27272727272727,88.0,0,6,5,0,11
37792,96.0,96.0,96.0,0,6,0,0,6
37802,86.0,86.0,86.0,2,1,3,0,6
37818,96.0,96.0,96.0,0,2,0,0,2
37820,92.0,93.0,90.0,0,2,3,1,6
37833,92.0,93.5,92.0,0,3,1,0,4
37879,84.0,82.38095238095238,75.0,1,9,11,0,21
37882,86.0,86.0,86.0,0,6,4,0,10
37986,92.0,92.0,92.0,0,0,2,0,2
38070,82.0,84.4,82.0,0,5,5,0,10
38072,73.0,76.25,73.0,2,9,9,0,20
38073,94.0,93.25,92.0,0,6,2,0,8
38106,87.0,87.0,87.0,1,1,1,0,3
38112,90.0,90.25,88.0,0,2,6,0,8
38139,87.0,87.0,87.0,1,1,1,0,3
38179,94.0,95.6,94.0,0,3,1,1,5
38182,100.0,100.0,100.0,0,0,0,1,1
38197,92.0,92.0,92.0,0,2,1,0,3
38201,92.0,91.6,91.0,1,3,1,0,5
38202,72.0,73.66666666666667,72.0,4,4,4,0,12
38231,92.0,93.0,92.0,0,3,3,0,6
38247,96.0,97.33333333333333,96.0,0,0,2,1,3
38258,68.0,70.8,68.0,3,6,6,0,15
38259,86.5,86.5,85.0,1,4,3,0,8
38306,94.0,94.66666666666667,94.0,0,1,2,0,3
38307,90.0,90.0,90.0,0,3,1,0,4
38330,94.0,92.54545454545455,89.0,1,5,5,0,11
38379,89.0,90.0,88.0,1,7,4,0,12
38423,97.0,97.0,96.0,0,0,2,2,4
38427,65.0,71.15384615384616,65.0,4,5,4,0,13
38442,71.0,69.72727272727273,63.0,5,7,10,0,22
38458,92.0,92.0,92.0,0,2,1,0,3
38479,90.0,92.4,90.0,0,3,2,0,5
38485,88.0,85.375,77.0,1,8,7,0,16
38530,82.0,82.0,82.0,0,3,3,0,6
38564,83.0,80.22222222222223,74.0,6,10,2,0,18
38566,81.0,85.125,81.0,1,4,3,0,8
38580,88.0,86.07692307692308,83.0,1,7,5,0,13
38606,87.0,86.58333333333333,86.0,2,7,3,0,12
38611,82.0,82.0,78.0,2,5,3,0,10
38752,88.0,91.0,88.0,0,3,3,0,6
38788,90.0,91.33333333333333,89.0,1,1,3,1,6
38797,92.0,92.0,92.0,0,2,1,0,3
38798,94.0,94.44444444444444,92.0,0,7,1,1,9
38808,69.0,71.0,69.0,4,8,8,0,20
38882,100.0,100.0,100.0,0,0,0,2,2
38885,93.0,93.0,92.0,0,1,3,0,4
38929,80.0,81.20833333333333,77.0,1,15,8,0,24
39025,98.0,98.0,96.0,0,1,1,1,3
39047,92.0,90.8,86.0,0,4,5,1,10
39049,83.0,86.375,83.0,1,5,2,0,8
39050,100.0,100.0,100.0,0,0,0,1,1
39052,92.0,92.28571428571429,90.0,0,3,3,1,7
39053,90.0,90.85714285714286,90.0,0,2,5,0,7
39113,91.0,87.14285714285714,82.0,4,2,1,0,7
39119,87.5,87.5,85.0,1,9,0,0,10
39169,99.0,99.0,98.0,0,1,0,1,2
39176,79.0,79.0,79.0,1,3,2,0,6
39205,86.0,86.85714285714286,86.0,0,1,6,0,7
39295,94.0,94.0,94.0,0,3,0,1,4
39396,68.0,68.0,68.0,2,5,2,0,9
39398,85.0,87.375,83.0,2,12,2,0,16
39403,86.0,86.41666666666667,81.0,1,17,6,0,24
39495,99.0,99.0,98.0,0,1,0,1,2
39513,90.0,90.375,87.0,1,4,3,0,8
39528,81.0,82.66666666666667,74.0,3,5,7,0,15
39606,94.0,94.0,92.0,0,6,2,0,8
39608,76.0,79.3,76.0,3,6,1,0,10
39665,94.0,94.0,91.0,1,4,0,1,6
39667,83.0,85.125,82.0,2,7,7,0,16
39693,88.0,88.0,86.0,0,4,4,0,8
39695,90.0,92.0,89.0,1,2,4,1,8
39708,81.0,81.3076923076923,80.0,4,4,5,0,13
39776,65.0,64.14285714285714,63.0,8,4,2,0,14
39810,88.0,88.70588235294117,88.0,0,12,5,0,17
39824,86.0,85.66666666666667,81.0,1,2,8,1,12
39862,94.0,94.66666666666667,92.0,0,4,1,1,6
39875,92.0,93.33333333333333,92.0,0,0,3,0,3
39888,90.0,90.76923076923077,88.0,0,9,4,0,13
39936,96.0,95.2,92.0,0,2,2,1,5
39937,96.0,96.66666666666667,96.0,0,1,2,0,3
40001,90.0,90.4,90.0,1,2,2,0,5
40144,92.0,93.11111111111111,91.0,1,6,2,0,9
40185,87.0,87.91666666666667,81.0,2,5,5,0,12
40197,93.0,93.0,93.0,1,0,0,0,1
40216,75.0,75.0,75.0,1,1,4,0,6
40217,82.0,83.70588235294117,81.0,2,6,9,0,17
57552,69.0,69.0,68.0,4,7,5,0,16
57579,75.0,71.35,65.0,6,7,7,0,20
57601,98.0,98.0,98.0,0,1,0,0,1
57628,92.0,92.66666666666667,90.0,0,3,3,0,6
57630,96.0,96.5,96.0,0,3,1,0,4
57698,87.0,87.0,87.0,4,4,4,0,12
57751,94.0,94.0,94.0,0,2,2,0,4
57754,100.0,100.0,100.0,0,0,0,2,2
57755,92.0,91.11111111111111,90.0,0,5,4,0,9
58573,94.0,93.2,90.0,0,9,1,0,10
58574,87.0,89.25,87.0,2,4,2,0,8
58576,77.0,77.875,72.0,3,5,8,0,16
58610,86.0,86.0,85.0,2,1,3,0,6
58611,88.0,87.57142857142857,87.0,1,3,3,0,7
58612,100.0,100.0,100.0,0,0,0,1,1
58628,90.0,91.0909090909091,90.0,0,7,3,1,11
58637,93.0,93.8,92.0,1,2,2,0,5
58659,74.0,78.25,74.0,3,3,2,0,8
58673,84.0,83.55555555555556,83.0,1,3,5,0,9
58718,94.0,94.0,94.0,0,1,1,0,2
58745,83.0,83.88888888888889,83.0,2,5,2,0,9
58781,94.0,96.0,94.0,0,1,1,1,3
58803,80.0,81.33333333333333,72.0,2,5,5,0,12
58850,96.0,96.66666666666667,96.0,0,3,0,0,3
58861,93.0,93.0,93.0,1,0,0,0,1
58879,90.0,89.7,87.0,1,6,3,0,10
58922,83.0,86.66666666666667,83.0,1,2,3,0,6
59002,94.0,93.2,92.0,0,10,0,0,10
59009,90.0,91.6,90.0,0,2,3,0,5
59016,96.0,95.2,94.0,0,3,2,0,5
59021,94.0,93.71428571428571,92.0,0,5,2,0,7
59025,85.0,85.14285714285714,84.0,2,9,3,0,14
59040,88.5,89.25,88.0,1,2,5,0,8
59041,92.0,92.44444444444444,90.0,0,5,4,0,9
59044,78.0,78.0,78.0,2,0,2,0,4
59065,93.0,93.0,92.0,0,1,3,0,4
59141,98.0,98.0,98.0,0,2,0,0,2
59152,90.0,90.0,90.0,0,1,2,0,3
59153,83.0,80.95,77.0,2,15,3,0,20
59154,88.0,88.0,88.0,0,2,2,0,4
59178,83.0,83.625,79.0,4,9,3,0,16
59179,87.0,87.0,84.0,2,2,2,0,6
59215,94.0,94.57142857142857,94.0,0,6,1,0,7
59289,74.0,73.07142857142857,63.0,5,11,12,0,28
59331,87.0,87.27272727272727,85.0,3,4,4,0,11
59397,87.0,87.25,82.0,2,6,8,0,16
59407,86.0,87.77777777777777,86.0,0,6,3,0,9
59422,94.0,91.28571428571429,87.0,1,4,2,0,7
59464,100.0,100.0,100.0,0,0,0,1,1
59520,92.0,91.55555555555556,90.0,0,6,3,0,9
59574,86.0,86.4375,85.0,2,8,6,0,16
59577,77.0,78.52380952380952,73.0,6,9,6,0,21
59599,90.0,90.85714285714286,89.0,1,2,4,0,7
59637,84.5,85.25,83.0,4,1,3,0,8
59638,92.0,90.4,88.0,0,6,4,0,10
59651,80.5,80.5,80.0,3,5,2,0,10
59691,91.0,93.33333333333333,91.0,1,2,0,0,3
59727,82.0,82.52631578947368,77.0,1,8,10,0,19
59777,96.0,96.0,96.0,0,2,1,0,3
59826,76.0,79.42857142857143,76.0,4,6,4,0,14
59828,67.0,69.91428571428571,55.0,4,19,11,1,35
59833,86.0,80.0625,69.0,4,6,6,0,16
59838,92.0,87.11111111111111,80.0,2,4,3,0,9
59872,89.0,88.63636363636364,87.0,2,8,1,0,11
59896,92.0,92.0,92.0,0,2,1,0,3
59934,78.0,83.81818181818181,78.0,0,2,9,0,11
59935,90.0,89.375,86.0,1,8,7,0,16
59949,91.0,90.125,85.0,2,2,4,0,8
59986,83.0,84.71428571428571,83.0,2,2,3,0,7
59988,84.0,87.33333333333333,84.0,0,1,5,0,6
60067,90.0,89.1,87.0,1,5,4,0,10
60114,92.0,92.0,92.0,0,6,3,0,9
60115,77.0,80.18181818181819,77.0,1,4,6,0,11
60208,88.0,88.9,87.0,1,5,4,0,10
60210,87.0,88.83333333333333,86.0,2,6,4,0,12
60230,92.0,92.0,92.0,0,0,2,0,2
60254,96.0,96.4,96.0,0,5,0,0,5
60331,81.0,76.76470588235294,71.0,2,8,7,0,17
60334,81.0,81.93333333333334,80.0,1,5,9,0,15
60349,87.0,87.0,87.0,0,0,0,1,1
60354,79.0,81.23529411764706,76.0,4,7,6,0,17
60355,88.0,82.4,74.0,2,8,5,0,15
60380,93.0,93.0,92.0,0,1,3,0,4
60387,95.0,96.0,94.0,0,1,2,1,4
60400,90.0,89.11111111111111,87.0,1,4,4,0,9
60445,94.0,94.5,92.0,0,1,3,0,4
60472,86.0,84.21428571428571,81.0,1,6,7,0,14
60473,85.0,85.5909090909091,79.0,3,16,3,0,22
60475,76.0,82.0,76.0,2,3,3,0,8
60484,83.5,83.5,81.0,1,5,4,0,10
60518,78.0,78.0,78.0,2,2,1,0,5
60544,97.0,97.5,96.0,0,3,0,1,4
60554,94.0,93.66666666666667,93.0,1,1,1,0,3
60555,100.0,100.0,100.0,0,0,0,3,3
60561,90.0,93.33333333333333,90.0,0,3,1,2,6
60616,89.0,92.0,89.0,1,1,1,0,3
60628,92.0,92.57142857142857,92.0,0,3,4,0,7
60631,100.0,100.0,100.0,0,0,0,1,1
60632,100.0,100.0,100.0,0,0,0,1,1
60633,100.0,100.0,100.0,0,0,0,2,2
60644,90.0,90.6,90.0,0,6,4,0,10
60649,94.0,94.57142857142857,94.0,0,7,0,0,7
60657,100.0,100.0,100.0,0,0,0,1,1
60713,98.0,97.0,93.0,1,1,0,1,3
60737,86.0,88.57142857142857,86.0,0,3,4,0,7
60786,92.0,88.44444444444444,81.0,1,2,5,1,9
60823,92.0,93.0,92.0,0,2,2,0,4
60824,93.0,93.0,92.0,0,1,3,0,4
60825,96.0,96.0,96.0,0,0,2,0,2
60828,90.0,89.875,87.0,1,5,2,0,8
60833,98.0,98.0,96.0,0,0,1,1,2
60898,83.0,84.5,83.0,2,4,2,0,8
60933,82.0,82.0,81.0,2,5,3,0,10
60984,90.0,88.4,86.0,2,1,2,0,5
61001,100.0,100.0,100.0,0,0,0,2,2
61016,90.0,91.6,90.0,0,2,3,0,5
61056,92.0,92.1,87.0,1,4,4,1,10
61073,80.0,83.0,80.0,3,1,2,0,6
61093,87.0,86.33333333333333,82.0,3,2,4,0,9
61109,100.0,99.33333333333333,98.0,0,1,0,2,3
61136,85.0,84.6875,78.0,3,9,4,0,16
61180,81.0,82.14285714285714,81.0,3,6,5,0,14
61187,92.0,92.0,92.0,0,2,3,0,5
61206,84.0,84.0,84.0,0,4,2,0,6
61285,91.0,92.0,89.0,2,3,1,0,6
61324,93.0,93.0,93.0,2,0,0,0,2
61326,98.0,98.0,96.0,0,0,1,1,2
61351,86.0,88.66666666666667,86.0,0,7,2,0,9
61357,91.0,91.0,91.0,1,1,0,0,2
61390,96.0,96.0,96.0,0,2,1,0,3
61427,66.0,66.0,66.0,2,2,4,0,8
61438,87.0,86.55555555555556,85.0,3,3,3,0,9
61460,85.0,85.92857142857143,83.0,2,7,5,0,14
61467,88.0,89.14285714285714,86.0,0,7,7,0,14
61493,88.0,90.4,88.0,0,1,4,0,5
61494,61.0,67.41379310344827,61.0,7,5,17,0,29
61499,84.0,84.5,83.0,2,8,4,0,14
61500,94.0,94.0,94.0,0,3,3,0,6
61512,92.0,92.0,92.0,0,2,1,0,3
61514,88.0,87.35714285714286,85.0,2,6,6,0,14
61516,96.0,96.66666666666667,96.0,0,3,0,0,3
61550,92.5,92.5,91.0,1,2,1,0,4
61563,94.0,92.33333333333333,89.0,1,2,3,0,6
61579,77.0,72.88,67.0,2,14,9,0,25
61592,91.0,91.0,91.0,2,2,0,0,4
61598,83.0,87.33333333333333,83.0,1,1,4,0,6
61602,90.0,88.66666666666667,85.0,1,4,4,0,9
61612,94.0,94.5,94.0,0,3,1,0,4
61623,95.0,95.0,94.0,0,1,3,0,4
61635,90.0,90.5,88.0,0,4,4,0,8
61641,94.0,95.2,94.0,0,2,2,1,5
61643,87.0,88.0,85.0,2,2,4,0,8
61669,86.0,87.28571428571429,86.0,1,3,3,0,7
61736,87.0,88.375,86.0,1,11,4,0,16
61806,100.0,99.2,96.0,0,0,1,4,5
61823,83.0,81.66666666666667,80.0,3,4,2,0,9
61856,94.0,94.0,94.0,0,6,0,0,6
61861,60.0,69.61538461538461,60.0,5,6,2,0,13
61915,83.0,83.0,80.0,4,3,4,0,11
61923,95.0,95.5,94.0,0,2,2,0,4
61953,94.0,94.0,94.0,0,1,1,0,2
61959,96.0,95.14285714285714,94.0,0,7,0,0,7
61976,81.0,83.42857142857143,81.0,1,5,1,0,7
61989,67.0,73.3,67.0,3,2,5,0,10
62000,92.0,92.0,90.0,0,7,2,0,9
62010,91.0,91.33333333333333,88.0,0,1,5,0,6
62051,88.0,88.0,88.0,0,2,2,0,4
62056,88.0,91.0,88.0,0,4,4,0,8
62060,94.5,95.0,91.0,1,2,0,1,4
62064,93.0,93.0,92.0,0,5,1,0,6
62067,93.0,93.0,93.0,1,0,0,0,1
62069,92.0,93.0,92.0,0,2,2,0,4
62179,90.0,90.66666666666667,90.0,0,4,5,0,9
62251,100.0,100.0,100.0,0,0,0,2,2
62277,87.0,87.0,87.0,1,1,1,0,3
62298,98.0,98.0,98.0,0,2,0,0,2
62308,86.0,86.0,86.0,0,1,3,0,4
62330,87.0,78.92307692307692,68.0,5,6,2,0,13
62334,92.0,92.0,92.0,0,0,2,0,2
62362,96.0,96.0,96.0,0,2,0,0,2
62419,96.0,96.66666666666667,96.0,0,3,0,0,3
62435,98.0,98.0,98.0,0,1,0,0,1
62445,98.0,98.0,98.0,0,1,0,0,1
62462,77.0,76.9,73.0,3,11,6,0,20
62487,96.0,96.0,96.0,0,0,2,0,2
62526,100.0,100.0,100.0,0,0,0,1,1
62532,90.0,88.625,85.0,1,1,6,0,8
62548,84.0,84.9375,83.0,1,11,4,0,16
62550,78.0,82.0,78.0,0,3,6,0,9
62551,92.0,93.6,92.0,0,0,4,1,5
62552,97.0,97.5,96.0,0,3,0,1,4
62560,88.0,87.81818181818181,86.0,0,4,7,0,11
62572,94.0,96.0,94.0,0,1,1,1,3
62573,84.5,84.5,83.0,1,2,5,0,8
62578,66.0,69.11111111111111,66.0,1,7,10,0,18
62597,85.0,83.78947368421052,77.0,2,10,7,0,19
62632,78.0,80.66666666666667,78.0,2,2,5,0,9
62658,100.0,100.0,100.0,0,0,0,1,1
62674,99.0,98.5,96.0,0,1,1,2,4
62688,88.0,88.22222222222223,86.0,3,5,1,0,9
62701,78.0,82.3076923076923,78.0,1,6,6,0,13
62702,92.0,92.0,92.0,0,0,2,0,2
62708,90.0,88.28571428571429,83.0,1,7,6,0,14
62717,96.0,96.0,96.0,0,0,2,0,2
62730,93.0,93.0,93.0,2,0,0,0,2
62735,76.0,78.45454545454545,73.0,4,8,10,0,22
62739,92.0,90.9,88.0,1,4,5,0,10
62765,81.0,80.84615384615384,78.0,4,3,6,0,13
62767,97.0,97.0,96.0,0,1,1,0,2
62768,90.0,91.33333333333333,90.0,0,4,2,0,6
62769,74.0,76.0,73.0,6,3,6,0,15
62771,80.0,84.18181818181819,80.0,0,5,6,0,11
62775,94.0,95.2,94.0,0,4,1,0,5
62777,90.0,90.0,90.0,0,3,5,0,8
62779,84.0,85.2,84.0,0,9,6,0,15
62780,90.0,90.0,90.0,0,1,2,0,3
62784,92.0,92.66666666666667,90.0,0,6,3,0,9
62785,87.0,87.375,84.0,1,1,6,0,8
62814,98.0,96.33333333333333,93.0,1,2,0,0,3
62816,100.0,100.0,100.0,0,0,0,3,3
62889,95.0,95.5,94.0,0,2,2,0,4
62896,81.0,79.8,78.0,3,4,3,0,10
62900,83.0,83.66666666666667,83.0,3,4,5,0,12
62939,100.0,99.0,96.0,0,0,1,3,4
62990,94.0,93.75,93.0,1,3,0,0,4
63000,97.0,97.0,96.0,0,1,1,0,2
63016,86.0,88.375,86.0,1,3,4,0,8
63047,92.0,92.25,89.0,1,6,1,0,8
63049,90.0,93.33333333333333,90.0,0,3,1,2,6
63077,94.0,94.66666666666667,94.0,0,1,1,1,3
63079,100.0,100.0,100.0,0,0,0,2,2
63082,78.0,76.0,70.0,4,10,9,0,23
63084,80.0,73.21052631578948,63.0,5,9,5,0,19
63095,98.0,98.0,98.0,0,1,0,0,1
63112,92.0,92.0,92.0,0,2,1,0,3
63119,96.0,96.0,96.0,0,0,1,0,1
63121,81.0,83.22222222222223,81.0,1,3,5,0,9
63136,97.0,97.0,96.0,0,1,1,0,2
63150,72.0,72.0,72.0,2,1,3,0,6
63156,82.5,82.5,81.0,1,0,7,0,8
63169,88.0,86.23529411764706,81.0,1,10,6,0,17
63191,84.0,84.0,80.0,2,3,7,0,12
63248,94.0,96.0,94.0,0,1,1,1,3
63256,60.0,69.81818181818181,60.0,5,3,3,0,11
63265,86.5,86.5,85.0,1,4,3,0,8
63280,81.0,78.82352941176471,75.0,2,6,9,0,17
63286,83.0,81.93333333333334,79.0,2,10,3,0,15
63287,65.0,73.75,65.0,3,4,5,0,12
63297,98.0,98.0,98.0,0,1,0,0,1
63303,81.0,81.0,81.0,0,0,0,1,1
63304,98.0,98.0,96.0,0,0,1,1,2
63406,92.0,92.0,92.0,0,2,1,0,3
63413,94.0,92.75,90.0,0,3,5,0,8
63429,87.0,87.0,87.0,0,0,0,1,1
63447,86.0,84.72727272727273,81.0,1,1,9,0,11
63488,94.0,94.66666666666667,94.0,0,1,2,0,3
63489,100.0,100.0,100.0,0,0,0,2,2
63493,83.0,82.46153846153847,78.0,4,7,2,0,13
63503,88.0,90.66666666666667,88.0,0,4,2,0,6
63554,90.5,90.83333333333333,89.0,1,2,2,1,6
63576,92.0,92.76923076923077,92.0,0,12,1,0,13
63597,90.0,90.75,89.0,1,4,3,0,8
63601,80.0,78.55555555555556,72.0,2,8,8,0,18
63615,94.0,94.0,94.0,0,5,2,0,7
63618,96.0,94.8,91.0,1,3,0,1,5
63619,92.0,90.8,89.0,1,2,2,0,5
63646,91.0,93.33333333333333,91.0,1,2,0,0,3
63651,88.0,90.4,88.0,0,2,2,1,5
63652,90.0,91.57142857142857,90.0,1,4,2,0,7
63653,70.0,78.0,70.0,3,5,5,0,13
63654,98.0,98.0,96.0,0,0,1,1,2
63713,96.0,96.4,96.0,0,5,0,0,5
63755,78.0,77.78571428571429,68.0,2,17,9,0,28
63757,85.0,84.27272727272727,80.0,3,3,5,0,11
63763,73.0,73.9,72.0,4,7,9,0,20
63773,80.0,80.0,80.0,2,1,1,0,4
63860,94.0,93.33333333333333,92.0,0,2,4,0,6
63893,86.0,86.75,86.0,0,3,5,0,8
63896,89.0,89.0,89.0,1,0,1,0,2
63897,90.0,90.3076923076923,88.0,0,7,6,0,13
63918,92.0,94.0,92.0,0,2,1,1,4
63940,86.0,86.15789473684211,85.0,1,12,6,0,19
63943,100.0,97.6,94.0,0,1,1,3,5
63971,88.0,88.0,88.0,0,2,2,0,4
63992,81.0,83.83333333333333,81.0,1,3,2,0,6
64004,94.0,94.22222222222223,92.0,0,7,2,0,9
64007,94.0,94.44444444444444,92.0,0,16,2,1,19
64008,90.0,93.2,90.0,0,1,3,1,5
64021,79.0,79.0,79.0,1,1,3,0,5
64057,92.0,92.0,92.0,0,0,2,0,2
64067,88.0,90.5,88.0,0,1,3,0,4
64076,88.0,89.0,86.0,0,7,5,0,12
64092,96.0,93.14285714285714,88.0,0,2,4,1,7
64101,98.0,98.0,96.0,0,0,1,1,2
64116,88.0,90.18181818181819,88.0,0,4,7,0,11
64141,90.0,87.94117647058823,83.0,1,12,4,0,17
64154,88.0,87.11111111111111,86.0,0,5,4,0,9
64161,87.0,81.8125,70.0,3,6,7,0,16
64176,79.0,78.38095238095238,69.0,5,9,7,0,21
64195,88.0,88.93333333333334,86.0,0,10,5,0,15
64213,90.5,90.5,89.0,1,4,1,0,6
64231,90.0,89.85714285714286,87.0,1,3,3,0,7
64236,88.0,84.0,75.0,3,3,5,0,11
64308,90.0,88.5,85.0,2,3,3,0,8
64338,83.0,86.0,83.0,1,2,4,0,7
64346,73.0,80.63636363636364,73.0,1,4,6,0,11
64351,92.0,91.2,86.0,2,0,2,1,5
64361,92.0,95.42857142857143,92.0,0,4,0,3,7
64379,92.0,92.0,90.0,0,9,3,0,12
64380,88.0,86.07692307692308,83.0,1,7,5,0,13
64384,87.0,90.6,87.0,1,3,1,0,5
64416,90.0,90.54545454545455,90.0,0,8,3,0,11
64420,94.0,94.66666666666667,94.0,0,1,2,0,3
64454,82.0,83.77777777777777,80.0,4,2,3,0,9
64466,86.0,86.0,86.0,0,3,2,0,5
64484,85.0,88.85714285714286,85.0,1,5,1,0,7
64490,100.0,100.0,100.0,0,0,0,1,1
64492,96.0,96.0,96.0,0,2,0,0,2
64496,82.0,84.66666666666667,82.0,0,2,4,0,6
64501,88.0,84.07692307692308,79.0,2,7,4,0,13
64513,94.0,94.0,92.0,0,3,4,0,7
64524,86.0,86.42857142857143,86.0,1,2,4,0,7
64525,76.0,79.6,76.0,3,5,2,0,10
64612,80.0,80.3125,77.0,2,6,8,0,16
64636,88.0,88.0,88.0,0,2,2,0,4
64653,80.0,82.72727272727273,80.0,0,7,4,0,11
64660,84.0,84.0,81.0,2,3,3,0,8
64667,92.0,92.33333333333333,91.0,1,2,3,0,6
64682,87.5,87.5,85.0,1,5,2,0,8
64717,92.0,94.0,92.0,0,1,2,0,3
64723,76.0,81.25,76.0,2,2,4,0,8
64745,88.0,88.85714285714286,88.0,0,3,4,0,7
64790,85.0,88.85714285714286,85.0,1,5,1,0,7
64805,87.0,88.11111111111111,86.0,1,3,5,0,9
64814,82.0,82.3076923076923,76.0,4,7,2,0,13
64835,86.0,86.36363636363636,84.0,0,2,9,0,11
64843,87.0,86.0,84.0,1,9,4,0,14
64859,96.0,95.71428571428571,94.0,0,6,1,0,7
64884,92.0,92.66666666666667,90.0,0,3,3,0,6
64933,85.0,84.27272727272727,83.0,3,3,5,0,11
64938,81.5,82.66666666666667,79.0,1,6,5,0,12
64940,92.0,94.0,92.0,0,3,2,0,5
64958,82.0,85.0,82.0,0,2,6,0,8
65007,91.0,91.0,90.0,0,7,1,0,8
65014,82.0,80.52941176470588,77.0,2,8,7,0,17
65026,87.0,89.75,87.0,2,8,1,1,12
65051,90.0,91.2,90.0,2,1,2,0,5
65057,92.0,87.2,80.0,2,5,3,0,10
65060,98.0,98.0,98.0,0,1,0,0,1
65066,82.0,77.84615384615384,71.0,6,4,3,0,13
65086,87.0,87.0,86.0,0,3,5,0,8
65111,86.0,86.57142857142857,84.0,0,9,5,0,14
65137,81.0,82.42857142857143,81.0,2,5,7,0,14
65139,79.0,82.18181818181819,79.0,1,6,4,0,11
65181,90.0,90.5,86.0,0,4,4,0,8
65238,86.0,86.23076923076923,83.0,2,3,8,0,13
65241,88.0,88.85714285714286,88.0,0,3,4,0,7
65245,91.0,91.45454545454545,90.0,1,7,3,0,11
65260,94.0,93.14285714285714,92.0,0,4,3,0,7
65265,96.0,96.0,96.0,0,0,2,0,2
65267,92.0,92.66666666666667,92.0,0,1,5,0,6
65270,96.0,96.25,93.0,1,2,0,1,4
65271,94.0,93.0,89.0,1,3,2,0,6
65277,100.0,100.0,100.0,0,0,0,2,2
65283,92.0,92.0,90.0,0,8,4,0,12
65348,70.0,75.38461538461539,70.0,2,6,5,0,13
65350,86.0,86.0,84.0,0,7,7,0,14
65358,96.5,96.5,93.0,1,0,0,1,2
65369,96.5,96.5,93.0,1,0,0,1,2
65382,79.5,79.5,78.0,3,0,5,0,8
65383,88.0,88.85714285714286,88.0,0,3,4,0,7
65391,90.5,90.5,89.0,1,0,3,0,4
65392,94.0,94.0,92.0,0,5,1,1,7
65396,89.5,89.3,87.0,2,2,6,0,10
65412,90.0,90.0,90.0,0,1,2,0,3
65415,94.0,93.14285714285714,92.0,0,4,3,0,7
65425,100.0,100.0,100.0,0,0,0,2,2
65442,80.0,84.28571428571429,80.0,2,2,3,0,7
65487,90.0,89.125,87.0,2,3,3,0,8
65529,88.0,88.0,86.0,0,4,4,0,8
65531,92.0,93.6,92.0,0,4,1,0,5
65549,96.0,96.25,93.0,1,2,0,1,4
65554,93.0,93.0,92.0,0,5,1,0,6
65561,81.0,83.26315789473684,79.0,2,8,9,0,19
65580,76.0,79.11111111111111,76.0,3,2,4,0,9
65582,88.0,88.4,88.0,1,0,4,0,5
65602,98.0,98.0,96.0,0,1,1,1,3
65622,92.0,92.0,92.0,0,2,3,0,5
65624,92.0,92.0,92.0,0,2,1,0,3
65635,71.0,78.25,71.0,3,0,2,3,8
65649,90.0,89.27272727272727,88.0,0,6,5,0,11
65672,92.0,91.45454545454545,88.0,0,7,4,0,11
65674,75.0,77.25,75.0,2,11,6,1,20
65676,88.0,89.71428571428571,88.0,0,4,3,0,7
65677,92.0,90.125,87.0,1,3,4,0,8
65679,81.0,81.42857142857143,79.0,3,10,8,0,21
65692,94.0,94.66666666666667,94.0,0,5,1,0,6
65695,77.0,81.33333333333333,77.0,1,3,5,0,9
65724,97.0,97.0,96.0,0,1,1,0,2
65725,92.0,94.0,92.0,0,2,1,1,4
65770,90.0,89.11111111111111,85.0,1,5,3,0,9
65776,92.0,93.71428571428571,92.0,0,5,1,3,9
65791,87.0,87.58333333333333,86.0,3,5,4,0,12
65795,84.0,86.0,80.0,2,6,6,0,14
65813,85.0,86.23076923076923,83.0,2,2,9,0,13
65819,99.0,99.0,98.0,0,2,0,2,4
65820,96.0,96.28571428571429,94.0,0,6,1,0,7
65824,85.0,87.66666666666667,85.0,3,6,0,0,9
65829,83.0,83.0,83.0,1,1,2,0,4
65830,93.0,93.0,92.0,1,1,3,0,5
65831,74.0,75.58333333333333,73.0,6,9,9,0,24
65833,94.0,94.0,92.0,0,2,2,0,4
65834,78.0,74.76923076923077,71.0,3,5,5,0,13
65852,88.0,90.85714285714286,88.0,0,3,4,0,7
65856,84.0,79.45,73.0,1,13,6,0,20
65857,92.0,92.0,92.0,0,2,1,0,3
65860,84.0,85.0,84.0,1,5,3,0,9
65872,90.0,90.0,90.0,0,1,2,0,3
65873,86.0,84.63636363636364,81.0,2,4,5,0,11
65893,100.0,99.2,96.0,0,0,1,4,5
65896,86.0,87.0,86.0,0,5,7,0,12
65898,93.0,93.66666666666667,90.0,0,3,2,1,6
65900,96.0,96.0,96.0,0,0,2,0,2
65901,92.0,91.8,90.0,0,8,2,0,10
65902,89.0,89.0,89.0,1,2,0,0,3
65925,87.0,85.71428571428571,82.0,1,9,4,0,14
66185,95.0,96.0,94.0,0,1,2,1,4
66191,100.0,99.33333333333333,98.0,0,1,0,2,3
66202,94.0,95.33333333333333,94.0,0,2,1,0,3
66220,85.0,85.0,84.0,0,5,5,0,10
66229,83.0,79.63636363636364,64.0,7,8,7,0,22
66255,89.0,88.0,86.0,1,2,6,0,9
66276,65.0,69.58333333333333,65.0,5,2,5,0,12
66279,99.0,99.0,98.0,0,1,0,1,2
66280,90.0,92.4,90.0,0,3,2,0,5
66297,86.0,87.45454545454545,86.0,2,6,3,0,11
66331,84.0,86.0,84.0,0,5,4,0,9
66336,85.0,88.0,85.0,1,3,2,0,6
66361,81.0,78.33333333333333,68.0,5,5,5,0,15
66362,88.0,90.0,88.0,0,3,3,0,6
66363,92.0,91.28571428571429,89.0,1,3,3,0,7
66384,86.5,86.7,83.0,2,5,3,0,10
66394,92.0,92.0,92.0,0,2,1,0,3
66400,79.0,80.33333333333333,75.0,3,8,7,0,18
66402,94.0,94.0,90.0,0,6,2,2,10
66406,78.0,77.6875,73.0,4,5,7,0,16
66411,96.0,96.0,96.0,0,2,0,0,2
66418,79.0,78.84210526315789,73.0,7,7,5,0,19
66475,90.0,90.6,90.0,0,6,4,0,10
66515,86.0,87.71428571428571,86.0,0,2,5,0,7
66517,84.0,81.53846153846153,76.0,2,5,6,0,13
66522,78.0,78.72727272727273,78.0,2,4,5,0,11
66534,88.0,89.33333333333333,88.0,0,4,4,1,9
66536,90.0,88.46153846153847,83.0,1,8,4,0,13
66583,94.0,94.0,94.0,0,2,2,0,4
66584,90.0,90.0,90.0,0,2,4,0,6
66592,98.0,98.0,96.0,0,1,1,1,3
66612,92.0,93.33333333333333,92.0,0,3,2,1,6
66637,86.0,84.5,78.0,3,5,6,0,14
66656,87.0,92.0,87.0,1,5,0,1,7
66679,70.0,74.61538461538461,70.0,3,8,2,0,13
66684,96.5,96.5,93.0,1,0,0,1,2
66685,88.5,88.0,85.0,2,3,7,0,12
66687,96.0,97.2,96.0,0,3,1,1,5
66694,87.0,87.0,82.0,2,6,0,0,8
66695,73.0,78.25,73.0,4,2,2,0,8
66704,85.0,84.92307692307692,84.0,1,5,7,0,13
66705,75.0,73.18181818181819,71.0,4,2,5,0,11
66709,96.0,96.0,96.0,0,2,0,0,2
66711,90.0,90.0,90.0,0,5,0,0,5
66717,85.0,87.4,85.0,2,1,2,0,5
66732,88.0,87.8,86.0,0,2,8,0,10
66736,90.0,91.6,90.0,0,2,3,0,5
66768,98.0,98.0,96.0,0,2,0,2,4
66771,98.0,96.33333333333333,93.0,1,2,0,0,3
66808,91.5,91.4,88.0,1,5,4,0,10
66874,78.0,71.6,58.0,4,7,9,0,20
66894,98.0,97.33333333333333,96.0,0,2,1,0,3
66896,94.0,93.6,92.0,0,1,4,0,5
66900,81.0,81.04761904761905,77.0,2,11,8,0,21
66901,83.5,83.5,81.0,1,5,4,0,10
66902,90.0,90.0,90.0,0,4,3,0,7
66925,90.0,91.25,89.0,1,4,3,0,8
66961,57.0,66.41176470588235,57.0,2,6,9,0,17
66963,94.0,93.33333333333333,92.0,0,2,4,0,6
66972,96.0,96.0,96.0,0,2,0,0,2
66979,98.0,98.0,96.0,0,0,1,1,2
66985,86.0,88.42857142857143,86.0,1,3,3,0,7
66988,81.0,83.57142857142857,81.0,2,1,4,0,7
66990,86.5,87.35714285714286,84.0,1,4,9,0,14
66992,86.0,86.33333333333333,86.0,2,0,0,1,3
66999,82.5,82.5,81.0,1,4,5,0,10
67043,83.0,83.06666666666666,78.0,4,3,8,0,15
67049,90.0,93.42857142857143,90.0,0,6,1,0,7
67063,88.0,82.58823529411765,72.0,2,8,7,0,17
67067,90.0,89.75,88.0,0,1,7,0,8
67075,86.5,86.5,85.0,1,4,3,0,8
67093,92.0,93.88888888888889,90.0,1,2,4,2,9
67123,90.5,90.5,89.0,1,0,3,0,4
67149,92.0,92.0,92.0,0,2,1,0,3
67154,87.0,86.92307692307692,86.0,1,8,4,0,13
67176,90.0,90.0,90.0,0,1,2,0,3
67182,96.0,92.0,86.0,2,2,1,0,5
67184,88.0,91.6,88.0,0,1,4,0,5
67186,89.5,89.83333333333333,85.0,1,1,4,0,6
67187,96.0,96.0,92.0,0,2,2,3,7
67218,90.0,90.0,90.0,0,1,2,0,3
67235,86.0,86.08333333333333,83.0,1,7,4,0,12
67237,51.0,57.6,51.0,5,5,5,0,15
67246,91.0,92.66666666666667,91.0,1,1,1,0,3
67250,98.0,98.0,98.0,0,2,0,0,2
67262,84.0,84.42857142857143,82.0,0,5,9,0,14
67276,94.0,94.0,94.0,0,1,1,0,2
67330,86.5,86.5,85.0,1,4,3,0,8
67359,88.0,86.66666666666667,82.0,2,1,6,0,9
67371,80.0,82.9090909090909,80.0,0,6,5,0,11
67414,100.0,100.0,100.0,0,0,0,1,1
67427,95.0,95.0,92.0,0,2,2,0,4
67446,79.0,72.94117647058823,65.0,6,6,5,0,17
67448,77.5,80.07142857142857,75.0,3,6,5,0,14
67489,94.0,94.0,94.0,0,6,0,0,6
67495,88.0,89.5,85.0,2,4,2,0,8
67509,100.0,100.0,100.0,0,0,0,1,1
67510,78.0,78.0,77.0,2,5,5,0,12
67545,98.0,96.8,94.0,0,2,1,2,5
67554,75.0,74.52631578947368,73.0,4,6,9,0,19
67558,94.0,94.0,94.0,0,5,2,0,7
67564,67.0,69.61764705882354,59.0,9,16,9,0,34
67565,83.0,83.8,81.0,1,9,10,0,20
67567,92.0,92.8,92.0,0,3,2,0,5
67584,90.0,92.5,90.0,0,1,2,1,4
67587,90.0,92.4,90.0,0,3,2,0,5
67602,96.0,93.42857142857143,90.0,0,5,2,0,7
67615,92.0,92.33333333333333,92.0,1,0,2,0,3
67690,94.0,94.66666666666667,94.0,0,1,2,0,3
67754,86.0,89.33333333333333,86.0,0,3,3,0,6
67788,84.0,85.25,82.0,2,0,5,1,8
67828,85.0,87.44444444444444,85.0,2,4,3,0,9
67856,92.0,93.33333333333333,92.0,0,0,3,0,3
67862,94.0,90.71428571428571,85.0,1,3,3,0,7
67869,84.0,86.9090909090909,81.0,3,4,4,0,11
67871,99.0,98.5,96.0,0,1,1,2,4
67895,90.0,89.16666666666667,86.0,3,1,2,0,6
67911,94.0,94.0,94.0,0,1,1,0,2
67917,100.0,100.0,100.0,0,0,0,2,2
67920,83.0,83.1875,81.0,2,10,4,0,16
67923,90.0,89.6,89.0,1,1,3,0,5
67982,87.0,87.5,85.0,2,1,5,0,8
67985,88.0,88.45454545454545,87.0,1,6,4,0,11
68013,99.0,99.0,98.0,0,1,0,1,2
68018,93.0,93.66666666666667,90.0,0,1,4,1,6
68026,88.5,89.25,85.0,1,5,2,0,8
68036,75.0,82.84615384615384,75.0,1,7,5,0,13
68037,81.0,81.0,81.0,1,2,2,0,5
68042,75.0,75.0,75.0,1,3,3,0,7
68045,92.0,94.0,92.0,0,2,1,1,4
68070,80.0,80.66666666666667,75.0,3,3,6,0,12
68079,94.0,94.5,92.0,0,1,3,0,4
68089,88.0,90.57142857142857,88.0,0,5,2,0,7
68090,92.0,91.6,91.0,1,3,1,0,5
68091,90.0,90.0,90.0,0,1,2,0,3
68104,88.0,87.33333333333333,86.0,2,2,2,0,6
68105,87.0,87.0,86.0,0,3,5,0,8
68121,80.0,84.57142857142857,80.0,2,5,0,0,7
68128,100.0,100.0,100.0,0,0,0,2,2
68130,79.0,78.26315789473684,77.0,3,10,6,0,19
68131,82.0,81.36842105263158,72.0,2,6,11,0,19
68148,81.0,83.25,81.0,2,3,3,0,8
68152,93.0,93.8,92.0,1,2,2,0,5
68158,92.0,92.0,92.0,0,2,1,0,3
68159,75.0,80.2,75.0,1,3,6,0,10
68160,70.0,72.0,68.0,4,6,11,0,21
68173,94.0,94.66666666666667,94.0,0,5,4,0,9
68189,88.0,88.33333333333333,86.0,1,9,5,0,15
68196,97.0,97.0,96.0,0,1,1,0,2
68219,96.0,95.2,94.0,0,3,2,0,5
68242,86.5,86.5,85.0,1,4,3,0,8
68247,87.0,87.3,84.0,3,3,3,1,10
68249,85.0,85.45454545454545,82.0,5,1,5,0,11
68257,97.0,97.0,94.0,0,1,1,2,4
68258,96.0,95.0,93.0,1,0,2,0,3
68259,96.0,95.33333333333333,94.0,0,5,1,0,6
68260,94.0,95.33333333333333,94.0,0,2,1,0,3
68262,100.0,100.0,100.0,0,0,0,1,1
68269,96.0,96.5,94.0,0,2,1,1,4
68283,100.0,99.33333333333333,98.0,0,1,0,2,3
68294,87.0,91.0,87.0,1,2,2,0,5
68295,94.0,94.66666666666667,94.0,0,1,2,0,3
68298,94.0,93.66666666666667,91.0,1,4,1,0,6
68320,85.0,79.46153846153847,72.0,4,4,5,0,13
68321,84.0,84.0,84.0,0,2,3,0,5
68331,88.0,88.0,88.0,0,2,2,0,4
68345,87.0,89.25,87.0,1,1,2,0,4
68351,87.5,87.5,86.0,3,0,1,0,4
68352,92.0,92.57142857142857,92.0,0,4,3,0,7
68353,94.0,93.2,91.0,1,2,2,0,5
68356,92.0,94.66666666666667,92.0,0,0,2,1,3
68360,90.0,91.25,90.0,0,4,3,1,8
68365,92.0,92.8,92.0,0,3,2,0,5
68366,87.0,85.2,77.0,2,9,4,0,15
68386,94.0,94.0,94.0,0,1,1,0,2
68390,81.0,80.25,79.0,3,7,6,0,16
68394,90.0,89.88888888888889,85.0,1,2,6,0,9
68403,75.0,74.4,71.0,3,8,9,0,20
68407,92.0,92.66666666666667,92.0,0,7,2,0,9
68428,90.0,89.92857142857143,85.0,1,11,2,0,14
68430,92.0,92.5,92.0,0,2,6,0,8
68431,88.0,88.0,88.0,0,2,2,0,4
68442,83.0,83.0,78.0,2,6,2,0,10
68451,88.0,82.46153846153847,74.0,2,6,5,0,13
68454,76.0,76.9090909090909,76.0,4,5,2,0,11
68467,97.0,97.0,94.0,0,1,1,2,4
68483,87.0,87.46666666666667,86.0,2,8,5,0,15
68493,83.0,82.88235294117646,81.0,4,6,7,0,17
68503,90.0,90.0,90.0,0,3,1,0,4
68504,96.0,96.5,94.0,0,2,1,1,4
68540,94.0,93.25,92.0,0,6,2,0,8
68560,78.0,83.33333333333333,78.0,2,5,2,0,9
68597,98.0,98.0,98.0,0,1,0,0,1
68602,100.0,100.0,100.0,0,0,0,2,2
68615,73.0,74.0,70.0,7,4,11,0,22
68629,90.0,90.0,90.0,0,1,2,0,3
68644,76.0,79.11111111111111,76.0,3,2,4,0,9
68649,87.0,83.5,73.0,1,1,1,1,4
68672,82.0,82.47058823529412,80.0,0,8,9,0,17
68674,95.0,95.33333333333333,94.0,0,6,0,0,6
68699,100.0,99.33333333333333,98.0,0,1,0,2,3
68716,80.0,85.33333333333333,80.0,2,3,1,0,6
68739,88.0,89.0,88.0,1,2,2,0,5
68753,74.0,82.22222222222223,74.0,2,1,5,1,9
68763,88.0,88.0,88.0,0,4,4,0,8
68768,78.0,78.0625,74.0,5,7,4,0,16
68773,87.0,87.0,87.0,1,1,1,0,3
68774,96.0,96.0,96.0,0,2,0,0,2
68784,99.0,98.5,96.0,0,1,1,2,4
68799,80.0,86.0,80.0,2,5,1,0,8
68813,71.0,72.77777777777777,71.0,6,0,3,0,9
68814,94.0,94.28571428571429,94.0,0,3,4,0,7
68826,79.0,83.0909090909091,79.0,1,7,3,0,11
68827,92.0,91.14285714285714,90.0,0,1,6,0,7
68831,83.0,83.0,83.0,2,2,4,0,8
68832,83.0,81.57142857142857,78.0,3,5,6,0,14
68865,89.5,89.5,87.0,1,3,2,0,6
68890,81.0,82.36363636363636,81.0,1,6,4,0,11
68894,91.0,92.0,90.0,1,3,4,0,8
68895,94.0,93.55555555555556,92.0,0,9,0,0,9
68909,96.0,96.0,96.0,0,2,1,0,3
68916,82.0,80.57142857142857,76.0,4,5,5,0,14
68944,95.0,96.0,94.0,0,1,2,1,4
68955,94.0,94.66666666666667,94.0,0,4,2,0,6
68961,85.0,85.0,85.0,1,0,2,0,3
68963,90.0,90.0,90.0,0,1,2,0,3
68974,98.0,97.6,96.0,0,4,0,1,5
68986,79.0,78.46666666666667,77.0,4,4,7,0,15
68998,84.0,88.28571428571429,84.0,0,3,4,0,7
69006,97.0,97.0,96.0,0,4,0,0,4
69016,78.0,77.2258064516129,72.0,7,18,6,0,31
69041,84.5,84.78571428571429,80.0,5,5,4,0,14
69069,95.0,95.5,94.0,0,2,2,0,4
69081,98.0,98.0,96.0,0,0,1,1,2
69110,84.0,84.5625,80.0,3,6,7,0,16
69113,94.0,94.0,94.0,0,3,0,0,3
69115,85.0,84.64285714285714,83.0,2,8,4,0,14
69118,87.0,87.0,87.0,1,1,1,0,3
69121,87.0,87.0,87.0,1,1,1,0,3
69127,100.0,100.0,100.0,0,0,0,1,1
69135,100.0,100.0,100.0,0,0,0,5,5
69172,96.0,95.33333333333333,94.0,0,5,1,0,6
69175,83.0,80.92307692307692,76.0,4,4,5,0,13
69181,92.0,92.66666666666667,89.0,1,1,4,0,6
69186,81.0,80.25,77.0,5,9,6,0,20
69188,94.0,93.11111111111111,92.0,0,8,1,0,9
69194,90.0,90.18181818181819,88.0,0,9,2,0,11
69207,90.0,91.55555555555556,90.0,0,5,4,0,9
69208,87.0,91.4,87.0,1,1,2,1,5
69214,94.0,94.0,92.0,0,2,3,0,5
69217,92.0,92.0,92.0,0,0,2,0,2
69237,100.0,100.0,100.0,0,0,0,3,3
69244,90.0,89.33333333333333,88.0,0,8,4,0,12
69249,94.0,94.57142857142857,92.0,0,4,2,1,7
69253,86.5,86.57142857142857,82.0,3,6,5,0,14
69259,98.0,98.0,96.0,0,0,1,1,2
69282,60.5,60.5,57.0,5,8,7,0,20
69288,91.0,91.0,91.0,1,1,0,0,2
69290,99.0,99.0,98.0,0,1,0,1,2
69291,94.0,94.4,92.0,0,1,3,1,5
69299,75.0,71.22222222222223,60.0,5,5,8,0,18
69324,86.0,86.23529411764706,84.0,4,6,7,0,17
69350,97.0,97.0,96.0,0,1,1,0,2
69351,85.5,85.22222222222223,84.0,1,8,9,0,18
69353,85.0,81.375,75.0,4,6,6,0,16
69368,94.0,93.2,92.0,0,3,2,0,5
69383,97.0,97.0,96.0,0,1,1,0,2
69388,94.0,92.33333333333333,89.0,1,2,3,0,6
69392,84.0,84.4,84.0,1,6,3,0,10
69397,64.0,64.0,64.0,2,5,3,0,10
69403,86.5,87.25,86.0,1,7,4,0,12
69419,85.0,82.65,77.0,2,10,8,0,20
69437,100.0,100.0,100.0,0,0,0,1,1
69465,93.0,94.0,93.0,2,0,1,0,3
69466,88.0,83.45454545454545,74.0,0,5,6,0,11
69475,92.0,92.88888888888889,90.0,0,6,3,0,9
69486,64.0,70.17647058823529,64.0,3,10,4,0,17
69487,88.0,92.0,88.0,0,2,3,0,5
69489,86.0,87.0,86.0,1,1,4,0,6
69492,92.0,92.0,92.0,0,4,0,0,4
69501,90.0,90.0,88.0,0,5,5,0,10
69512,96.0,96.0,96.0,0,0,1,0,1
69520,87.0,88.5,87.0,2,1,1,0,4
69527,92.0,91.3,87.0,1,5,4,0,10
69528,97.0,97.0,96.0,0,1,1,0,2
69547,99.0,99.0,98.0,0,1,0,1,2
69576,92.0,92.5,90.0,0,6,2,0,8
69584,83.0,83.0,82.0,0,3,7,0,10
69590,92.0,92.33333333333333,89.0,1,2,2,1,6
69595,87.0,92.2,87.0,1,1,1,2,5
69606,79.0,79.1875,77.0,2,4,10,0,16
69618,69.0,69.0,69.0,3,5,0,0,8
69621,86.0,89.25,86.0,0,4,4,0,8
69627,96.0,96.0,96.0,0,2,2,0,4
69653,77.0,77.0,77.0,1,4,2,0,7
69664,90.0,90.0,90.0,0,3,1,0,4
69665,86.0,85.14285714285714,83.0,2,9,3,0,14
69666,84.0,85.8,84.0,0,7,3,0,10
69679,98.0,98.0,96.0,0,1,1,1,3
69680,92.0,92.66666666666667,92.0,0,5,1,0,6
69691,84.0,84.0,78.0,2,3,3,0,8
69694,76.0,81.36363636363636,76.0,3,3,5,0,11
69705,92.0,91.0,88.0,0,7,3,0,10
69706,90.0,88.125,85.0,1,5,2,0,8
69737,89.5,89.5,87.0,1,7,0,0,8
69753,91.5,91.83333333333333,87.0,1,4,1,0,6
69759,75.0,76.15,71.0,2,9,9,0,20
69761,96.0,96.5,94.0,0,2,1,1,4
69762,77.0,76.69565217391305,70.0,4,7,12,0,23
69769,90.0,91.27272727272727,88.0,0,7,3,1,11
69782,88.0,88.5,88.0,0,7,5,0,12
69786,87.0,87.88888888888889,87.0,3,5,1,0,9
69792,84.0,84.0,84.0,1,3,5,0,9
69799,86.0,87.76470588235294,83.0,2,9,6,0,17
69813,92.0,91.75,90.0,0,1,7,0,8
69828,84.5,85.25,77.0,3,4,1,0,8
69849,94.0,93.0,90.0,0,6,2,0,8
69885,90.0,90.88888888888889,90.0,0,5,4,0,9
69895,100.0,98.66666666666667,96.0,0,0,1,2,3
69909,92.0,91.85714285714286,90.0,0,12,2,0,14
69945,85.0,85.0,85.0,1,0,2,0,3
69957,88.0,88.0,86.0,0,3,7,0,10
69962,68.0,74.92307692307692,68.0,2,6,5,0,13
70014,75.0,75.0,75.0,3,0,1,0,4
70017,84.0,85.42857142857143,78.0,0,7,7,0,14
70019,86.0,87.125,85.0,3,1,4,0,8
70022,77.0,77.45454545454545,77.0,3,4,4,0,11
70034,91.0,91.0,90.0,0,3,3,0,6
70045,92.0,94.0,92.0,0,2,1,1,4
70058,98.0,98.0,98.0,0,2,0,0,2
70064,84.0,83.0,75.0,4,1,8,0,13
70071,92.0,94.0,92.0,0,3,2,0,5
70090,92.0,92.375,90.0,1,3,4,0,8
70123,96.0,96.0,96.0,0,0,1,0,1
70132,85.5,85.5,84.0,3,2,1,0,6
70141,98.0,98.0,98.0,0,2,0,0,2
70142,83.0,82.0,75.0,8,2,7,0,17
70148,88.0,87.63636363636364,85.0,1,5,5,0,11
70182,94.0,93.75,92.0,0,7,1,0,8
70184,83.0,79.35714285714286,72.0,3,4,7,0,14
70207,93.0,93.0,92.0,0,1,3,0,4
70210,98.0,98.0,98.0,0,1,0,0,1
70217,96.0,96.0,96.0,0,4,0,0,4
70220,100.0,99.33333333333333,98.0,0,1,0,2,3
70225,94.0,93.66666666666667,91.0,1,4,1,0,6
70254,98.0,98.0,98.0,0,1,0,0,1
70258,92.0,92.0,92.0,0,0,4,0,4
70281,79.0,75.625,67.0,5,7,4,0,16
70282,92.0,93.6,92.0,0,4,1,0,5
70305,99.0,99.0,98.0,0,1,0,1,2
70306,82.0,82.0,82.0,0,3,3,0,6
70309,90.0,92.8,90.0,0,2,3,0,5
70365,85.0,87.8,85.0,1,0,4,0,5
70418,92.0,93.0,92.0,0,2,2,0,4
70425,98.0,96.4,94.0,0,3,1,1,5
70434,90.0,89.6,89.0,1,1,3,0,5
70452,90.0,89.0,86.0,0,4,6,0,10
70459,88.0,90.0,88.0,0,3,3,0,6
70486,86.0,86.9090909090909,86.0,0,6,5,0,11
70494,94.0,92.28571428571429,90.0,0,3,4,0,7
70516,92.0,91.1,87.0,1,8,1,0,10
70521,79.0,79.73333333333333,74.0,3,5,7,0,15
70562,92.0,91.0,88.0,0,7,5,0,12
70576,85.5,85.5,85.0,1,7,2,0,10
70619,90.0,89.6,89.0,1,1,3,0,5
70641,71.0,77.0,71.0,4,1,3,0,8
70685,88.0,87.81818181818181,86.0,0,4,7,0,11
70686,89.0,92.0,89.0,1,1,1,0,3
70702,94.5,94.5,93.0,1,0,1,0,2
70705,94.0,95.33333333333333,94.0,0,2,1,0,3
70707,100.0,100.0,100.0,0,0,0,1,1
70717,87.0,86.33333333333333,85.0,3,8,1,0,12
70723,84.0,85.0,83.0,2,2,6,0,10
70755,100.0,100.0,100.0,0,0,0,3,3
70758,96.5,96.5,93.0,1,0,0,1,2
70778,92.0,92.125,87.0,1,3,3,1,8
70780,90.0,90.0,90.0,0,5,0,0,5
70823,92.0,92.0,92.0,0,2,1,0,3
70838,81.0,84.375,81.0,1,3,4,0,8
70839,92.5,92.5,89.0,1,2,1,0,4
70849,77.0,77.0,77.0,3,1,0,0,4
70856,90.0,90.0,88.0,0,1,6,0,7
70912,92.0,94.0,92.0,0,1,2,0,3
70914,80.0,80.4,79.0,2,4,9,0,15
70921,98.0,97.33333333333333,96.0,0,1,1,1,3
70922,90.0,91.6,90.0,0,2,3,0,5
70929,97.0,97.0,96.0,0,1,1,0,2
70949,90.0,91.6,90.0,0,2,3,0,5
70960,85.0,83.92857142857143,81.0,2,7,5,0,14
70961,98.0,98.0,96.0,0,2,2,2,6
70970,80.0,82.18181818181819,80.0,0,5,6,0,11
71008,65.0,65.54545454545455,59.0,7,8,7,0,22
71056,88.0,88.64285714285714,87.0,1,7,6,0,14
71057,90.0,87.4,81.0,1,8,6,0,15
71065,73.0,77.8,73.0,2,4,4,0,10
71067,94.0,93.25,90.0,0,3,4,1,8
71087,94.0,94.0,93.0,1,1,2,1,5
71131,79.0,79.66666666666667,79.0,3,4,8,0,15
71149,90.0,90.8,90.0,0,1,4,0,5
71154,98.0,98.5,98.0,0,3,0,1,4
71168,78.0,80.94117647058823,78.0,2,9,6,0,17
71187,96.0,96.0,96.0,0,0,2,0,2
71226,91.0,91.0,91.0,1,1,0,0,2
71232,69.0,69.8,69.0,4,6,5,0,15
71286,84.5,85.5,79.0,1,8,3,0,12
71292,92.0,93.0,92.0,0,2,2,0,4
71310,55.0,62.388888888888886,55.0,5,8,5,0,18
71322,77.0,79.0,77.0,2,7,3,0,12
71328,92.0,92.0,92.0,0,0,2,0,2
71356,88.0,88.0,87.0,2,3,1,0,6
71366,88.0,89.33333333333333,88.0,0,2,4,0,6
71380,92.0,91.27272727272727,88.0,0,5,6,0,11
71413,100.0,100.0,100.0,0,0,0,1,1
71422,90.0,90.8,90.0,0,1,4,0,5
71428,100.0,100.0,100.0,0,0,0,1,1
71430,90.0,90.0,90.0,0,3,1,0,4
71440,57.0,69.66666666666667,57.0,4,6,8,0,18
71456,96.0,93.2,89.0,1,2,2,0,5
71469,94.0,91.875,87.0,1,4,3,0,8
71476,92.0,93.33333333333333,92.0,0,0,3,0,3
71510,92.0,91.83333333333333,91.0,2,3,1,0,6
71524,79.0,79.0,79.0,1,8,3,0,12
71530,89.0,90.0,85.0,2,2,2,0,6
71532,93.0,93.0,92.0,0,5,1,0,6
71534,90.0,90.0,88.0,0,9,3,0,12
71563,94.0,94.8,94.0,0,5,0,0,5
71576,92.0,91.25,89.0,1,4,3,0,8
71640,94.0,96.0,94.0,0,4,0,1,5
71657,70.0,72.5,70.0,4,3,5,0,12
71696,89.0,89.46153846153847,86.0,1,7,5,0,13
71723,78.0,78.0,78.0,2,4,0,0,6
71780,94.0,96.0,94.0,0,1,1,1,3
71783,87.0,85.63636363636364,82.0,1,4,6,0,11
71803,94.0,94.66666666666667,94.0,0,5,1,0,6
71823,94.0,93.2,91.0,1,2,2,0,5
71831,80.0,81.81818181818181,80.0,1,6,4,0,11
71841,92.0,93.0,91.0,1,3,1,0,5
71909,86.0,86.52631578947368,82.0,0,13,6,0,19
71910,90.0,90.85714285714286,90.0,0,5,2,0,7
71915,84.0,84.0,84.0,0,2,3,0,5
71946,91.0,92.75,89.0,2,0,1,1,4
71962,83.0,86.88888888888889,83.0,2,5,1,1,9
71988,97.0,97.5,96.0,0,3,0,1,4
71999,87.0,86.77777777777777,83.0,2,3,4,0,9
72002,96.0,96.5,94.0,0,2,1,1,4
72004,80.0,81.125,79.0,3,8,5,0,16
72015,86.0,86.88888888888889,85.0,3,3,3,0,9
72020,96.0,95.14285714285714,92.0,0,3,4,0,7
72024,87.0,85.46666666666667,80.0,4,8,3,0,15
72027,82.0,83.8,82.0,0,5,5,0,10
72046,91.5,91.5,91.0,1,1,2,0,4
72049,80.0,80.0,78.0,0,10,10,0,20
72073,96.0,96.0,96.0,0,2,0,0,2
72093,81.0,79.05555555555556,76.0,4,11,3,0,18
72117,92.0,92.0,92.0,0,4,2,0,6
72153,91.0,92.0,90.0,0,3,3,0,6
72164,80.0,81.0,75.0,5,6,6,0,17
72169,90.0,91.6,90.0,0,2,3,0,5
72171,87.0,84.81818181818181,78.0,3,4,4,0,11
72176,66.0,66.0,66.0,2,4,3,0,9
73849,88.0,91.6,88.0,0,1,4,0,5
73871,75.0,77.5,75.0,2,5,5,0,12
73875,100.0,100.0,100.0,0,0,0,2,2
73889,76.0,76.0,71.0,4,2,4,0,10
73900,94.0,94.0,94.0,0,1,1,0,2
73902,95.0,95.0,94.0,0,3,1,0,4
73906,100.0,98.66666666666667,96.0,0,0,1,2,3
73949,86.0,85.42857142857143,82.0,0,7,7,0,14
73955,89.0,86.14285714285714,79.0,3,14,4,0,21
73963,86.0,89.55555555555556,86.0,0,5,4,0,9
73978,94.0,94.0,94.0,0,1,1,0,2
73985,90.0,90.0,90.0,0,4,3,0,7
73998,90.0,90.0,90.0,0,1,2,0,3
74010,74.0,76.8,74.0,3,3,4,0,10
74039,98.0,97.2,96.0,0,5,0,0,5
74116,91.0,91.0,91.0,1,1,0,0,2
74131,83.5,84.0625,82.0,1,11,4,0,16
74133,94.0,92.15384615384616,88.0,0,11,2,0,13
74149,82.0,79.9375,75.0,1,5,10,0,16
74168,84.0,83.55555555555556,83.0,1,3,5,0,9
74202,92.0,93.25,92.0,0,4,4,0,8
74210,89.0,87.0909090909091,83.0,2,7,2,0,11
74229,82.0,84.75,82.0,3,0,1,0,4
74237,87.0,89.55555555555556,87.0,2,3,4,0,9
74239,94.0,94.66666666666667,94.0,0,1,2,0,3
74240,94.0,94.5,94.0,0,3,1,0,4
74244,89.0,90.75,89.0,1,2,1,0,4
74283,77.5,78.88888888888889,74.0,0,10,8,0,18
74327,98.0,98.0,96.0,0,0,1,1,2
74336,100.0,100.0,100.0,0,0,0,2,2
74358,92.0,91.625,90.0,1,3,3,1,8
74371,77.0,77.0,77.0,1,2,3,0,6
74374,77.0,78.8,76.0,4,5,6,0,15
74399,86.0,85.4,83.0,2,2,6,0,10
74429,88.0,88.5,88.0,0,7,5,0,12
74436,92.0,93.6,92.0,0,4,1,0,5
74453,83.0,84.66666666666667,83.0,2,4,6,0,12
74468,88.0,87.11111111111111,86.0,0,5,4,0,9
74485,85.0,87.75,85.0,1,0,3,0,4
74509,96.0,96.0,96.0,0,0,1,0,1
74522,92.0,92.0,92.0,0,4,0,0,4
74524,97.0,97.0,96.0,0,1,1,0,2
74536,96.0,96.0,96.0,0,0,2,0,2
74537,98.0,98.0,98.0,0,2,0,0,2
74563,83.0,84.0,76.0,2,8,2,0,12
74591,79.0,83.875,79.0,1,3,4,0,8
74626,94.0,96.0,94.0,0,1,1,1,3
74680,94.0,93.6,92.0,0,1,4,0,5
74712,87.0,89.5,87.0,2,3,3,0,8
74722,94.0,94.0,94.0,0,3,0,0,3
74756,94.0,95.33333333333333,94.0,0,2,1,0,3
74759,92.5,92.5,91.0,1,2,1,0,4
74763,88.0,88.41666666666667,85.0,2,4,6,0,12
74797,90.0,91.5,90.0,0,1,3,0,4
74800,83.0,83.5,77.0,5,2,1,0,8
74829,96.0,96.66666666666667,96.0,0,3,0,0,3
74854,92.0,92.0,92.0,0,4,2,0,6
74866,80.0,80.0,79.0,2,3,5,0,10
74922,86.0,86.0,86.0,0,3,2,0,5
74952,100.0,99.0,96.0,0,0,1,3,4
74955,94.0,92.07142857142857,82.0,3,8,2,1,14
74973,86.0,86.0,86.0,0,3,2,0,5
74983,97.0,97.0,96.0,0,4,0,0,4
74989,98.0,98.0,98.0,0,1,0,0,1
74993,83.0,83.0,83.0,1,1,2,0,4
74999,94.0,94.66666666666667,94.0,0,1,2,0,3
75013,87.0,87.8,87.0,2,1,2,0,5
75055,98.0,97.6,96.0,0,4,1,0,5
75063,81.0,82.14285714285714,81.0,3,6,5,0,14
75113,82.0,84.66666666666667,82.0,0,3,6,0,9
75147,87.0,87.0,87.0,1,1,1,0,3
75173,94.0,95.5,94.0,0,1,2,1,4
75187,80.0,81.25,75.0,2,2,8,0,12
75217,80.0,80.0,77.0,4,8,4,0,16
75223,88.0,88.88888888888889,88.0,0,4,5,0,9
75235,92.0,92.5,92.0,0,5,3,0,8
75297,83.0,83.85714285714286,83.0,2,1,4,0,7
75306,89.0,90.2,89.0,1,2,2,0,5
75349,98.0,98.0,98.0,0,1,0,0,1
75350,90.0,90.0,90.0,0,1,2,0,3
75353,81.0,82.28571428571429,81.0,3,7,4,0,14
75375,90.0,90.0,90.0,0,3,1,0,4
75402,80.0,83.28571428571429,79.0,2,14,5,0,21
75406,93.0,93.2,92.0,0,4,6,0,10
75407,89.0,91.33333333333333,89.0,1,0,2,0,3
75411,94.0,94.0,94.0,0,2,2,0,4
75429,89.0,91.0,89.0,1,3,1,0,5
75437,100.0,100.0,100.0,0,0,0,2,2
75448,90.0,90.0,90.0,0,1,2,0,3
75452,79.0,78.54545454545455,78.0,3,5,3,0,11
75453,96.0,97.33333333333333,96.0,0,2,0,1,3
75465,100.0,98.4,96.0,0,0,2,3,5
75468,90.0,89.6,89.0,1,1,3,0,5
75523,88.0,87.7,87.0,1,3,6,0,10
75526,88.0,88.88888888888889,88.0,0,7,2,0,9
75530,83.0,84.42857142857143,81.0,2,4,8,0,14
75574,94.0,94.8,94.0,0,3,2,0,5
75604,90.0,90.25,89.0,1,3,4,0,8
75606,91.0,90.71428571428571,87.0,2,4,1,0,7
75613,92.0,90.42857142857143,88.0,1,2,4,0,7
75637,86.0,86.54545454545455,83.0,1,4,6,0,11
75649,94.0,94.0,94.0,0,1,1,0,2
75662,86.0,86.0,86.0,0,3,2,0,5
75678,88.0,87.57142857142857,87.0,1,3,3,0,7
75685,87.0,90.0,87.0,2,1,2,0,5
75689,90.0,91.6,90.0,0,2,3,0,5
75701,75.0,76.16666666666667,70.0,4,7,13,0,24
75738,82.0,84.46153846153847,82.0,1,8,4,0,13
75792,85.0,88.71428571428571,85.0,2,3,2,0,7
75836,94.0,95.0,94.0,0,3,3,0,6
75850,92.0,92.0,92.0,0,2,3,0,5
75851,100.0,100.0,100.0,0,0,0,2,2
75881,92.0,91.0,87.0,1,3,2,1,7
75888,90.0,91.0,90.0,0,8,4,0,12
75956,88.0,88.0,88.0,0,4,1,0,5
75962,85.0,89.71428571428571,85.0,1,3,2,1,7
75973,90.0,91.0,88.0,0,3,3,0,6
75991,88.0,89.5,88.0,0,6,2,0,8
76033,80.0,77.1,72.0,3,11,6,0,20
76060,100.0,100.0,100.0,0,0,0,1,1
76061,90.0,91.0,90.0,0,5,3,0,8
76064,100.0,100.0,100.0,0,0,0,1,1
76126,100.0,100.0,100.0,0,0,0,1,1
76156,92.0,92.33333333333333,90.0,0,2,4,0,6
76196,91.0,91.0,91.0,1,1,0,0,2
76205,97.0,97.5,96.0,0,3,0,1,4
76218,60.0,68.91666666666667,60.0,2,14,8,0,24
76220,90.0,91.6,90.0,0,2,3,0,5
76223,100.0,99.0,96.0,0,1,1,4,6
76233,94.0,93.63636363636364,90.0,0,3,6,2,11
76353,98.0,98.66666666666667,98.0,0,2,0,1,3
76373,84.0,84.0,84.0,0,4,2,0,6
76374,88.0,88.66666666666667,83.0,1,6,5,0,12
76401,82.0,81.91666666666667,81.0,4,3,5,0,12
76408,98.0,98.0,96.0,0,1,1,1,3
76409,94.0,94.0,94.0,0,1,1,0,2
76431,100.0,99.33333333333333,98.0,0,1,0,2,3
76436,90.0,90.0,90.0,0,3,3,0,6
76437,65.0,70.9375,65.0,1,8,7,0,16
76441,84.0,85.6,84.0,0,9,6,0,15
76465,87.0,88.4,87.0,2,7,1,0,10
76477,69.0,71.8,69.0,2,5,8,0,15
76479,96.0,97.33333333333333,96.0,0,2,0,1,3
76503,91.0,91.75,90.0,0,6,2,0,8
76510,75.0,75.0,70.0,2,6,6,0,14
76513,78.0,76.63636363636364,72.0,3,12,6,1,22
76543,90.0,89.6,89.0,1,1,3,0,5
76544,93.0,93.0,93.0,1,0,0,0,1
76545,94.0,94.0,94.0,0,9,0,0,9
76546,91.5,91.5,89.0,1,1,2,0,4
76574,100.0,100.0,100.0,0,0,0,4,4
76586,100.0,100.0,100.0,0,0,0,2,2
76588,100.0,99.33333333333333,98.0,0,1,0,2,3
76615,75.0,75.35,75.0,4,9,7,0,20
76633,97.0,97.0,96.0,0,1,1,0,2
76665,100.0,100.0,100.0,0,0,0,2,2
76677,81.0,83.83333333333333,81.0,1,3,2,0,6
76681,88.0,88.0,88.0,0,2,2,0,4
76685,85.0,84.94117647058823,80.0,3,11,3,0,17
76698,97.0,97.0,94.0,0,1,1,2,4
76725,91.5,89.16666666666667,83.0,2,7,3,0,12
76729,91.0,91.0,90.0,1,4,3,0,8
76733,83.0,86.4,83.0,1,1,2,1,5
76735,90.0,90.0,90.0,0,3,1,0,4
76763,92.0,93.0,92.0,1,2,2,0,5
76817,72.0,70.0952380952381,62.0,4,6,11,0,21
76874,88.0,83.23076923076923,74.0,2,6,5,0,13
76876,77.0,77.0,77.0,1,4,2,0,7
76883,99.0,99.0,98.0,0,1,0,1,2
76886,78.0,76.05882352941177,72.0,5,6,6,0,17
76895,96.0,96.0,96.0,0,0,1,0,1
76902,98.0,98.0,98.0,0,1,0,0,1
76909,92.0,91.125,87.0,1,5,2,0,8
76942,71.0,77.25,71.0,3,4,1,0,8
76950,75.0,79.15384615384616,75.0,1,7,5,0,13
76957,88.0,88.4,86.0,0,4,6,0,10
76958,86.0,85.28571428571429,84.0,0,6,8,0,14
76960,80.5,76.47058823529412,64.0,4,21,9,0,34
76962,83.0,83.0,83.0,1,1,2,0,4
76992,72.0,73.875,71.0,6,2,8,0,16
76997,90.0,88.83333333333333,85.0,1,9,2,0,12
77004,100.0,100.0,100.0,0,0,0,3,3
77005,93.0,93.66666666666667,92.0,0,4,2,0,6
77017,100.0,100.0,100.0,0,0,0,1,1
77031,79.0,82.0,79.0,1,3,5,0,9
77045,92.0,92.85714285714286,92.0,0,5,2,0,7
77054,80.0,81.33333333333333,80.0,0,3,6,0,9
77065,79.0,80.05882352941177,76.0,5,4,8,0,17
77080,96.0,96.0,96.0,0,0,1,0,1
77098,85.0,86.4,81.0,2,6,2,0,10
77108,74.0,74.0,74.0,2,2,2,0,6
77156,98.0,98.66666666666667,98.0,0,2,0,1,3
77162,77.0,77.9090909090909,77.0,2,3,6,0,11
77168,92.0,91.75,90.0,0,1,7,0,8
77169,94.0,94.0,92.0,0,2,2,0,4
77173,79.0,78.10526315789474,74.0,1,9,9,0,19
77252,80.0,80.0,80.0,2,1,1,0,4
77403,78.0,76.71428571428571,75.0,4,0,3,0,7
77404,68.0,70.33333333333333,68.0,5,3,4,0,12
77425,83.0,83.66666666666667,80.0,3,4,5,0,12
77427,94.0,92.66666666666667,90.0,0,6,3,0,9
77442,85.0,82.0,78.0,1,6,8,0,15
77462,94.0,94.66666666666667,94.0,0,1,2,0,3
77484,88.0,85.85714285714286,79.0,2,7,4,1,14
77515,96.0,96.0,96.0,0,2,0,0,2
77528,100.0,99.33333333333333,98.0,0,1,0,2,3
77532,77.0,74.63636363636364,62.0,0,6,5,0,11
77543,100.0,100.0,100.0,0,0,0,3,3
77546,95.0,95.0,94.0,0,3,1,0,4
77547,91.0,94.0,91.0,1,1,0,1,3
77548,71.0,74.61904761904762,65.0,10,8,3,0,21
77550,81.0,83.25,81.0,2,3,3,0,8
77558,86.0,84.3125,79.0,2,6,8,0,16
77559,90.0,90.0,90.0,0,1,2,0,3
77564,83.0,82.07142857142857,78.0,3,6,5,0,14
77566,88.0,88.61538461538461,88.0,0,9,4,0,13
77580,84.0,87.75,84.0,0,5,3,0,8
77611,80.5,81.3,76.0,4,1,5,0,10
77642,79.0,81.27272727272727,79.0,1,5,5,0,11
77645,71.0,78.33333333333333,71.0,4,5,3,0,12
77667,89.0,89.55555555555556,88.0,1,4,4,0,9
77681,73.0,76.0,73.0,3,6,3,0,12
77682,97.0,97.0,94.0,0,1,1,2,4
77693,82.0,80.82352941176471,77.0,1,7,9,0,17
77703,90.0,90.0,90.0,0,2,4,0,6
77705,100.0,100.0,100.0,0,0,0,1,1
77714,83.0,89.14285714285714,83.0,1,3,2,1,7
77731,92.5,92.5,89.0,1,0,3,0,4
77738,86.0,84.3157894736842,76.0,2,10,7,0,19
77750,97.0,97.0,96.0,0,1,1,0,2
77760,87.0,87.0,82.0,0,7,5,0,12
77761,85.0,87.8,85.0,1,0,4,0,5
77767,84.0,86.92307692307692,83.0,3,5,5,0,13
77769,89.0,89.0,88.0,0,5,3,0,8
77778,84.0,86.3,83.0,2,11,7,0,20
77781,88.0,88.75,86.0,0,2,6,0,8
77789,83.0,88.33333333333333,83.0,1,2,2,1,6
77799,94.0,95.33333333333333,94.0,0,2,1,0,3
77826,81.0,83.25,81.0,2,3,3,0,8
77850,80.0,78.08695652173913,71.0,5,10,8,0,23
77852,81.0,82.36363636363636,81.0,1,8,2,0,11
77858,94.0,95.33333333333333,94.0,0,2,3,1,6
77901,86.0,86.58823529411765,84.0,0,8,9,0,17
77919,88.0,88.0,88.0,0,2,2,0,4
77951,90.0,90.4,90.0,1,2,2,0,5
77955,96.5,96.5,93.0,1,0,0,1,2
77958,82.0,83.42857142857143,78.0,4,9,1,0,14
77960,75.0,78.5,72.0,5,7,8,0,20
77973,86.0,86.0,85.0,2,9,6,0,17
78028,83.0,82.5625,78.0,5,6,5,0,16
78063,90.0,90.3076923076923,88.0,0,8,5,0,13
78075,82.0,81.8,80.0,2,17,6,0,25
78102,83.0,80.21428571428571,76.0,5,7,2,0,14
78113,92.0,90.14285714285714,85.0,1,2,4,0,7
78143,90.0,91.6,90.0,0,2,3,0,5
78171,90.0,91.6,90.0,0,4,1,0,5
78172,90.0,89.77777777777777,88.0,0,5,4,0,9
78196,81.0,82.44444444444444,81.0,4,8,6,0,18
78207,83.0,86.0,83.0,2,5,2,0,9
78213,99.0,99.0,98.0,0,1,0,1,2
78215,83.0,77.82352941176471,72.0,4,9,4,0,17
78216,99.0,99.0,98.0,0,1,0,1,2
78219,94.0,94.66666666666667,92.0,0,4,1,1,6
78220,86.0,74.47368421052632,59.0,3,5,11,0,19
78243,77.0,81.58333333333333,77.0,1,8,3,0,12
78275,79.0,82.11111111111111,79.0,1,2,6,0,9
78306,90.0,89.8,89.0,1,6,3,0,10
78314,98.0,98.0,98.0,0,1,0,0,1
78328,64.0,66.75,61.0,5,12,7,0,24
78332,90.0,86.0,76.0,2,11,2,0,15
78338,92.0,92.0,92.0,0,2,1,0,3
78347,97.0,97.0,96.0,0,1,1,0,2
78368,96.5,96.5,93.0,1,0,0,1,2
78403,94.0,94.66666666666667,94.0,0,1,2,0,3
78406,86.0,87.71428571428571,86.0,0,2,5,0,7
78408,96.0,93.42857142857143,90.0,0,5,2,0,7
78426,79.0,84.71428571428571,79.0,1,2,3,1,7
78472,92.0,92.66666666666667,90.0,0,4,5,0,9
78481,85.0,85.0,85.0,1,0,2,0,3
78489,91.0,91.33333333333333,89.0,2,3,1,0,6
78536,100.0,98.66666666666667,96.0,0,0,1,2,3
78544,90.0,89.1,87.0,1,5,4,0,10
78601,82.0,82.0,82.0,2,2,0,0,4
78604,90.0,89.57142857142857,89.0,1,5,1,0,7
78619,90.0,90.85714285714286,90.0,0,5,2,0,7
78621,86.0,86.0,86.0,0,1,3,0,4
78642,90.0,91.6,90.0,0,2,3,0,5
78669,94.0,94.8,94.0,0,3,2,0,5
78670,94.0,94.66666666666667,94.0,0,5,1,0,6
78698,70.0,70.46153846153847,70.0,5,4,4,0,13
78705,90.0,92.5,90.0,0,1,2,1,4
78722,71.0,70.47368421052632,66.0,5,7,7,0,19
78724,100.0,100.0,100.0,0,0,0,2,2
78727,96.0,96.0,96.0,0,0,1,0,1
78747,88.0,86.0,80.0,2,2,7,0,11
78756,94.5,95.0,91.0,1,2,0,1,4
78762,90.0,91.33333333333333,90.0,0,4,2,0,6
78769,96.0,97.0,96.0,0,0,3,1,4
78779,76.0,78.95238095238095,74.0,6,10,5,0,21
78781,89.0,89.11111111111111,88.0,1,3,5,0,9
78793,85.0,85.0,85.0,1,3,1,0,5
78794,98.0,98.0,98.0,0,2,0,0,2
78819,100.0,100.0,100.0,0,0,0,1,1
78844,85.0,84.53333333333333,80.0,4,8,3,0,15
78852,80.0,83.0,80.0,3,1,2,0,6
78860,96.0,96.0,96.0,0,0,1,0,1
78903,85.0,89.8,85.0,1,1,3,0,5
78911,93.0,92.75,91.0,1,3,4,0,8
78928,86.0,87.42857142857143,86.0,0,5,2,0,7
78934,92.0,92.0,92.0,0,0,2,0,2
78946,100.0,100.0,100.0,0,0,0,2,2
78962,96.0,96.0,96.0,0,0,1,0,1
78965,82.5,82.5,81.0,1,4,5,0,10
78981,89.5,90.0,85.0,1,5,2,0,8
78983,94.0,96.0,94.0,0,1,1,1,3
78985,90.0,89.66666666666667,88.0,0,9,3,0,12
78988,100.0,100.0,100.0,0,0,0,2,2
78996,96.0,96.8,96.0,0,4,1,0,5
79010,92.0,92.0,92.0,0,0,2,0,2
79025,90.5,91.0,88.0,1,4,5,0,10
79050,88.0,83.85714285714286,77.0,1,7,6,0,14
79052,86.0,83.57142857142857,79.0,1,6,7,0,14
79053,81.0,79.47368421052632,71.0,5,6,8,0,19
79069,92.0,92.54545454545455,92.0,0,11,0,0,11
79070,92.0,92.0,92.0,0,2,1,0,3
79117,77.0,77.0,77.0,1,6,1,1,9
79125,94.0,94.66666666666667,94.0,0,2,4,0,6
79132,100.0,100.0,100.0,0,0,0,2,2
79156,94.0,94.0,94.0,0,4,1,0,5
79206,77.0,75.5,68.0,3,6,9,0,18
79212,85.0,88.0,85.0,1,4,2,0,7
79214,96.0,96.0,96.0,0,0,2,0,2
79217,96.0,96.33333333333333,94.0,0,4,1,1,6
79218,100.0,100.0,100.0,0,0,0,2,2
79220,98.0,98.0,98.0,0,1,0,1,2
79248,71.0,74.36,70.0,6,12,7,0,25
79267,98.0,98.0,98.0,0,1,0,0,1
79272,68.0,68.0,68.0,2,3,3,0,8
79296,96.0,92.14285714285714,87.0,1,5,1,0,7
79299,85.0,84.3,78.0,3,2,5,0,10
79329,98.0,97.33333333333333,96.0,0,2,1,0,3
79334,88.0,87.625,87.0,1,5,2,0,8
79345,83.0,83.375,75.0,5,7,4,0,16
79346,100.0,100.0,100.0,0,0,0,4,4
79347,90.0,90.0,90.0,0,1,2,0,3
79366,94.0,94.22222222222223,92.0,0,8,0,1,9
79368,100.0,100.0,100.0,0,0,0,1,1
79390,70.0,74.23076923076923,70.0,3,4,5,1,13
79401,92.0,91.66666666666667,89.0,1,2,3,0,6
79406,91.0,89.28571428571429,85.0,2,2,3,0,7
79407,100.0,100.0,100.0,0,0,0,4,4
79410,90.0,89.77777777777777,89.0,1,4,4,0,9
79412,89.0,92.6,89.0,1,4,0,0,5
79414,67.0,71.66666666666667,67.0,2,7,6,0,15
79427,87.0,86.8,85.0,2,3,5,0,10
79430,74.0,71.42857142857143,63.0,6,11,4,0,21
79432,88.0,88.6,88.0,0,3,7,0,10
79433,92.0,90.8,89.0,1,2,2,0,5
79525,90.0,91.0,88.0,1,7,5,0,13
79528,86.0,85.22222222222223,76.0,2,7,9,0,18
79563,83.0,85.625,83.0,1,4,3,0,8
79564,94.0,94.25,93.0,1,1,2,0,4
79565,86.0,88.25,86.0,0,5,3,0,8
79599,92.0,92.0,92.0,0,4,2,0,6
79607,100.0,100.0,100.0,0,0,0,1,1
79632,85.0,80.28571428571429,74.0,4,6,4,0,14
79654,76.0,79.22222222222223,76.0,5,1,3,0,9
79661,100.0,100.0,100.0,0,0,0,2,2
79704,87.0,89.0,87.0,1,1,3,0,5
79729,77.0,78.17857142857143,73.0,2,17,9,0,28
79753,94.0,94.8,94.0,0,3,2,0,5
79756,87.0,87.72727272727273,85.0,3,3,5,0,11
79782,88.0,89.0,87.0,1,4,4,0,9
79783,100.0,100.0,100.0,0,0,0,2,2
79794,89.0,89.0,89.0,1,0,1,0,2
79801,88.5,90.25,88.0,1,4,3,0,8
79805,92.0,92.18181818181819,90.0,0,7,4,0,11
79821,76.0,75.58823529411765,75.0,5,5,7,0,17
79829,90.0,89.81818181818181,88.0,0,7,4,0,11
79851,88.0,88.42857142857143,88.0,1,4,2,0,7
79916,86.0,88.57142857142857,86.0,0,3,4,0,7
79923,89.0,87.77777777777777,84.0,1,2,6,0,9
79954,100.0,100.0,100.0,0,0,0,4,4
79961,73.0,77.54166666666667,65.0,7,8,9,0,24
79970,92.0,92.5,92.0,0,5,3,0,8
79974,94.0,89.5,82.0,2,4,2,0,8
79989,88.0,83.5,76.0,2,4,6,0,12
80027,100.0,100.0,100.0,0,0,0,2,2
80037,86.0,90.0,86.0,0,6,2,0,8
80051,90.0,89.14285714285714,86.0,0,13,1,0,14
80063,88.0,89.33333333333333,88.0,0,3,6,0,9
80079,90.0,90.66666666666667,90.0,0,10,2,0,12
80081,78.0,78.0,75.0,3,8,9,0,20
80109,96.0,96.0,94.0,0,3,2,0,5
80120,92.0,92.0,90.0,0,4,2,0,6
80121,92.0,93.6,92.0,0,4,1,0,5
80137,80.0,81.45454545454545,75.0,5,3,3,0,11
80142,89.0,90.25,88.0,0,3,4,1,8
80164,83.0,80.4,75.0,6,1,3,0,10
80194,94.0,94.0,94.0,0,3,0,0,3
80201,88.0,88.0,88.0,0,2,2,0,4
80230,92.0,94.66666666666667,92.0,0,0,2,1,3
80233,74.0,73.47058823529412,71.0,6,3,8,0,17
80235,92.0,92.0,88.0,0,8,2,0,10
80236,81.5,82.375,75.0,2,10,4,0,16
80242,86.0,76.7,59.0,3,8,9,0,20
80253,76.0,77.81818181818181,76.0,2,3,6,0,11
80260,94.0,94.66666666666667,94.0,0,1,2,0,3
80285,90.0,88.3076923076923,84.0,0,7,5,1,13
80299,100.0,100.0,100.0,0,0,0,2,2
80305,95.0,95.0,94.0,0,3,1,0,4
80312,84.0,84.88888888888889,78.0,1,5,2,1,9
80313,65.0,70.85714285714286,65.0,2,6,6,0,14
80316,58.0,71.26315789473684,58.0,4,9,6,0,19
80417,80.0,82.25,80.0,1,2,5,0,8
80451,82.5,83.0,80.0,2,3,7,0,12
80479,82.0,83.6,82.0,0,4,6,0,10
80484,92.0,93.33333333333333,92.0,0,0,3,0,3
80487,96.0,96.0,96.0,0,2,0,0,2
80494,88.0,85.75,80.0,3,3,6,0,12
80495,80.0,81.44444444444444,79.0,5,7,6,0,18
80534,99.0,99.0,98.0,0,1,0,1,2
80549,85.0,85.0,85.0,1,2,1,0,4
80552,83.0,83.0,83.0,1,3,1,0,5
80554,92.0,92.0,92.0,0,0,2,0,2
80572,100.0,100.0,100.0,0,0,0,1,1
80573,99.0,99.0,98.0,0,1,0,1,2
80585,96.0,96.0,96.0,0,2,0,0,2
80587,83.0,83.0,83.0,2,2,4,0,8
80591,68.0,68.28571428571429,66.0,9,8,4,0,21
80592,96.0,96.0,96.0,0,4,0,0,4
80598,97.0,97.0,94.0,0,3,0,3,6
80619,92.0,91.66666666666667,89.0,1,1,4,0,6
80621,89.0,93.4,89.0,1,2,0,2,5
80624,89.0,93.4,89.0,1,2,0,2,5
80629,92.0,91.16666666666667,87.0,1,9,2,0,12
80631,79.0,80.94117647058823,77.0,2,9,6,0,17
80638,90.0,91.71428571428571,89.0,1,2,4,0,7
80659,81.5,82.14285714285714,72.0,3,7,4,0,14
80669,86.0,87.9,86.0,1,6,3,0,10
80679,86.0,86.0,86.0,2,0,0,0,2
80742,93.0,93.33333333333333,92.0,0,3,3,0,6
80744,92.0,93.0,92.0,0,2,2,0,4
80763,84.0,84.33333333333333,84.0,1,4,4,0,9
80773,93.0,92.6,91.0,2,2,1,0,5
80798,82.0,82.0,81.0,2,1,5,0,8
80819,96.0,96.66666666666667,96.0,0,3,0,0,3
80841,85.0,85.11111111111111,82.0,3,5,1,0,9
80861,94.0,95.5,94.0,0,1,1,2,4
80887,90.0,89.33333333333333,87.0,1,17,3,0,21
80893,92.0,91.28571428571429,90.0,1,3,3,0,7
80930,93.0,93.0,92.0,0,5,1,0,6
80931,88.0,87.66666666666667,86.0,0,6,6,0,12
80937,83.0,84.33333333333333,78.0,3,1,8,0,12
80961,94.0,94.75,93.0,1,2,1,0,4
80964,85.0,80.15384615384616,71.0,4,6,3,0,13
80975,98.0,98.0,98.0,0,1,0,0,1
80989,88.0,88.0,88.0,0,2,2,0,4
80995,96.0,96.5,94.0,0,2,1,1,4
81033,75.0,76.92307692307692,75.0,3,8,2,0,13
81064,96.0,97.33333333333333,96.0,0,0,2,1,3
81073,96.0,96.5,94.0,0,2,1,1,4
81077,96.0,96.5,94.0,0,2,1,1,4
81088,94.0,94.33333333333333,94.0,0,4,2,0,6
81089,77.0,78.81818181818181,77.0,2,4,5,0,11
81103,88.0,85.66666666666667,80.0,0,10,8,0,18
81116,86.0,87.0,85.0,1,6,5,0,12
81134,94.0,94.66666666666667,94.0,0,1,2,0,3
81135,89.5,89.5,89.0,1,3,2,0,6
81161,90.0,89.5,83.0,2,8,4,0,14
81164,85.0,89.42857142857143,85.0,1,4,2,0,7
81166,100.0,99.0,96.0,0,0,1,3,4
81167,87.0,89.0,87.0,1,1,3,0,5
81174,96.0,96.0,96.0,0,2,0,0,2
81187,81.0,79.5,73.0,4,9,7,0,20
81202,96.0,96.0,96.0,0,4,0,0,4
81235,86.0,84.6086956521739,79.0,2,11,10,0,23
81244,89.0,89.0,88.0,1,5,4,0,10
81250,90.0,90.85714285714286,90.0,0,5,2,0,7
81255,95.0,95.0,94.0,0,3,1,0,4
81258,90.0,89.0,86.0,2,2,4,0,8
81264,97.0,97.5,96.0,0,3,0,1,4
81284,94.0,95.33333333333333,94.0,0,2,1,0,3
81290,94.0,93.6,92.0,0,1,4,0,5
81291,100.0,100.0,100.0,0,0,0,3,3
81297,85.0,83.33333333333333,78.0,3,5,4,0,12
81302,79.0,78.11764705882354,76.0,4,7,6,0,17
81303,87.0,88.6,87.0,2,2,1,0,5
81310,92.0,94.4,92.0,0,2,2,1,5
81328,86.5,86.5,84.0,3,3,0,0,6
81349,81.5,81.5,77.0,1,4,5,0,10
81365,91.5,91.75,87.0,1,6,1,0,8
81368,92.0,92.0,89.0,1,3,2,0,6
81381,86.5,86.5,84.0,3,3,0,0,6
81383,74.0,76.77777777777777,69.0,3,6,8,1,18
81386,96.0,96.0,96.0,0,0,1,0,1
81409,76.0,80.0,76.0,3,3,3,0,9
81425,90.0,92.5,90.0,0,1,2,1,4
81442,80.0,82.22222222222223,80.0,1,2,6,0,9
81453,95.5,95.5,93.0,1,1,0,0,2
81460,75.0,78.63636363636364,75.0,2,5,4,0,11
81461,92.0,93.33333333333333,92.0,0,0,3,0,3
81471,84.0,86.5,84.0,0,5,3,0,8
81475,88.0,86.61538461538461,81.0,1,6,6,0,13
81484,89.0,89.0,86.0,0,1,7,0,8
81521,87.0,87.0,87.0,1,1,1,0,3
81522,84.0,85.8,82.0,3,7,5,0,15
81528,98.0,97.6,96.0,0,4,0,1,5
81539,94.0,93.6,91.0,1,3,1,0,5
81540,91.0,91.5,90.0,0,4,4,0,8
81579,91.0,90.66666666666667,88.0,1,6,2,0,9
81580,94.5,94.5,89.0,1,0,1,2,4
81588,92.0,90.85714285714286,89.0,2,4,1,0,7
81595,78.0,81.71428571428571,78.0,3,3,1,0,7
81602,87.0,85.7,80.0,3,4,3,0,10
81606,90.0,89.0909090909091,88.0,0,6,5,0,11
81637,96.0,96.0,96.0,0,0,1,0,1
81647,87.0,89.28571428571429,85.0,2,5,0,0,7
81651,78.0,77.10526315789474,69.0,8,6,5,0,19
81667,75.0,75.52631578947368,73.0,3,6,10,0,19
81704,85.0,85.0,85.0,2,2,3,0,7
81705,82.0,82.0,82.0,2,2,0,0,4
81713,87.0,87.22222222222223,85.0,2,3,4,0,9
81719,92.0,90.36363636363636,86.0,0,8,3,0,11
81756,98.0,98.0,98.0,0,2,0,0,2
81759,71.0,71.0,71.0,1,5,3,0,9
81796,98.0,98.0,98.0,0,1,0,0,1
81800,73.0,72.5,69.0,8,5,11,0,24
81812,94.0,93.66666666666667,93.0,1,1,1,0,3
81815,88.0,88.54545454545455,88.0,1,7,3,0,11
81839,70.5,70.5,66.0,5,6,3,0,14
81857,89.0,89.0,89.0,1,0,1,0,2
81861,92.0,92.0,92.0,0,6,1,0,7
81862,85.0,88.0,85.0,1,4,2,0,7
81866,82.0,79.44444444444444,72.0,4,5,9,0,18
81884,77.0,80.0,77.0,2,5,3,0,10
81887,84.5,84.5,83.0,1,2,5,0,8
81894,85.0,84.06666666666666,73.0,5,6,4,0,15
81919,90.0,91.5,90.0,0,1,3,0,4
81925,90.0,90.0,90.0,0,2,1,0,3
81956,88.0,88.85714285714286,88.0,0,3,4,0,7
81971,87.0,90.6,87.0,1,3,1,0,5
81974,92.0,92.0,92.0,0,2,3,0,5
81978,63.0,71.21428571428571,63.0,3,7,4,0,14
81987,80.0,79.53846153846153,79.0,1,7,5,0,13
82009,96.0,90.85714285714286,84.0,2,5,0,0,7
82022,81.0,81.0,81.0,1,2,2,0,5
82033,98.0,98.0,96.0,0,0,1,1,2
82041,79.0,78.28571428571429,76.0,5,6,10,0,21
82048,92.0,95.2,92.0,0,2,1,2,5
82058,81.0,84.42857142857143,81.0,2,1,4,0,7
82074,87.0,92.2,87.0,1,1,1,2,5
82090,96.0,96.0,96.0,0,2,1,0,3
82094,92.0,93.2,92.0,0,5,0,0,5
82095,84.0,86.27272727272727,84.0,2,4,5,0,11
82097,94.0,91.0,87.0,1,3,3,0,7
82100,87.5,87.5,81.0,1,6,3,0,10
82113,94.0,93.6,92.0,0,1,4,0,5
82114,100.0,100.0,100.0,0,0,0,3,3
82134,69.0,74.66666666666667,69.0,1,9,5,0,15
82141,92.0,92.33333333333333,92.0,1,0,2,0,3
82142,90.0,88.4,86.0,0,3,7,0,10
82143,87.0,89.42857142857143,87.0,2,4,1,0,7
82176,96.0,94.8,92.0,0,3,2,0,5
82196,88.0,90.57142857142857,88.0,0,3,4,0,7
82217,94.0,95.42857142857143,94.0,0,5,1,1,7
82218,90.0,90.0,88.0,0,4,5,0,9
82225,82.0,82.0,82.0,0,3,3,0,6
82228,76.0,78.0,76.0,5,3,6,0,14
82231,84.0,84.45454545454545,83.0,2,17,3,0,22
82259,77.0,81.25,77.0,1,3,4,0,8
82278,88.0,91.42857142857143,88.0,0,4,3,0,7
82290,92.0,92.8,92.0,0,3,2,0,5
82315,96.0,96.5,94.0,0,2,1,1,4
82324,91.0,93.33333333333333,91.0,1,2,0,0,3
82337,88.0,91.42857142857143,88.0,0,3,3,1,7
82339,77.0,77.0,77.0,1,2,3,0,6
82340,98.0,98.0,96.0,0,2,1,1,4
82345,84.0,82.94444444444444,78.0,3,12,3,0,18
82354,90.0,92.8,90.0,0,2,3,0,5
82361,64.0,69.33333333333333,64.0,2,5,5,0,12
82373,96.0,96.0,96.0,0,2,0,0,2
82376,88.0,85.9090909090909,81.0,1,4,6,0,11
82388,88.0,88.85714285714286,88.0,0,3,4,0,7
82407,100.0,100.0,100.0,0,0,0,1,1
82413,83.0,78.71428571428571,72.0,4,4,6,0,14
82416,88.0,88.33333333333333,88.0,1,2,3,0,6
82429,96.0,97.0,96.0,0,2,1,1,4
82453,90.0,91.5,90.0,0,1,3,0,4
82466,92.0,91.84615384615384,90.0,0,10,3,0,13
82476,81.0,85.33333333333333,81.0,1,1,4,0,6
82483,96.0,96.0,96.0,0,0,1,0,1
82485,79.0,79.0,79.0,1,3,2,0,6
82544,100.0,100.0,100.0,0,0,0,1,1
82550,86.0,88.66666666666667,86.0,0,2,4,0,6
82563,85.0,88.0,85.0,1,4,2,0,7
82578,94.0,94.0,94.0,0,1,1,1,3
82601,100.0,100.0,100.0,0,0,0,3,3
82635,94.5,94.16666666666667,91.0,2,4,0,0,6
82636,94.0,94.0,94.0,0,2,2,0,4
82653,96.0,97.33333333333333,96.0,0,2,0,1,3
82655,82.0,84.26315789473684,81.0,1,9,9,0,19
82656,81.0,84.6,81.0,1,7,2,0,10
82664,90.0,89.11111111111111,86.0,0,3,6,0,9
82677,88.0,87.57142857142857,87.0,1,3,3,0,7
82680,82.0,75.4,65.0,5,4,6,0,15
82700,88.0,87.42857142857143,84.0,2,6,6,0,14
82733,81.5,81.92857142857143,80.0,2,5,7,0,14
82792,94.0,93.83333333333333,93.0,1,4,1,0,6
82806,90.0,91.44444444444444,87.0,1,4,3,1,9
82807,90.0,90.66666666666667,90.0,0,3,3,0,6
82812,100.0,100.0,100.0,0,0,0,1,1
82869,63.0,69.92307692307692,63.0,4,4,5,0,13
82878,67.0,72.4,67.0,3,5,2,0,10
82892,90.0,89.2,87.0,1,6,3,0,10
82909,87.0,85.66666666666667,83.0,3,2,4,0,9
82911,88.0,91.14285714285714,88.0,0,4,3,0,7
82930,82.0,84.75,82.0,3,0,1,0,4
82932,98.0,98.0,96.0,0,0,1,1,2
82933,94.0,94.22222222222223,90.0,0,3,5,1,9
82934,88.0,83.17647058823529,75.0,2,8,7,0,17
82944,90.0,88.44444444444444,86.0,1,3,5,0,9
82945,89.0,89.75,88.0,0,3,5,0,8
82950,86.0,86.33333333333333,86.0,3,2,4,0,9
82955,96.0,96.66666666666667,96.0,0,1,2,0,3
82959,96.0,96.0,94.0,0,3,1,0,4
82992,92.0,94.4,92.0,0,2,2,1,5
83097,80.0,79.53846153846153,79.0,1,7,5,0,13
83102,100.0,100.0,100.0,0,0,0,1,1
83125,74.0,78.8,74.0,2,3,5,0,10
83134,94.0,92.55555555555556,89.0,1,6,2,0,9
83135,85.0,77.875,68.0,3,6,7,0,16
83148,90.0,88.5,81.0,1,10,3,0,14
83196,96.0,95.66666666666667,93.0,1,1,1,0,3
83305,84.0,81.76190476190476,75.0,2,12,7,0,21
83316,81.0,81.0,76.0,2,4,4,0,10
83327,93.5,93.5,91.0,1,3,0,0,4
83351,78.0,78.875,78.0,0,11,5,0,16
83352,100.0,99.33333333333333,98.0,0,1,0,2,3
83360,89.0,89.375,87.0,2,3,3,0,8
83362,94.0,94.33333333333333,94.0,0,4,2,0,6
83365,98.0,98.0,98.0,0,2,0,0,2
83369,86.0,88.4,86.0,0,9,1,0,10
83394,92.0,91.28571428571429,90.0,0,3,3,1,7
83403,88.0,84.72222222222223,78.0,1,12,5,0,18
83409,100.0,100.0,100.0,0,0,0,3,3
83423,75.0,76.68181818181819,72.0,6,8,8,0,22
83424,81.0,83.25,81.0,2,3,3,0,8
83472,82.0,76.8,68.0,7,2,6,0,15
83474,90.0,90.0,90.0,0,1,2,0,3
83475,94.0,94.0,94.0,0,2,2,0,4
83476,83.0,80.13333333333334,72.0,3,5,7,0,15
83497,90.0,90.85714285714286,90.0,0,5,2,0,7
83504,82.0,82.0,82.0,0,3,3,0,6
83522,100.0,100.0,100.0,0,0,0,1,1
83524,100.0,100.0,100.0,0,0,0,1,1
83553,90.0,90.25,88.0,0,2,6,0,8
83565,81.0,83.0,81.0,2,2,2,0,6
83566,79.0,83.625,79.0,2,1,5,0,8
83567,90.0,88.5,85.0,1,4,5,0,10
83570,63.0,70.36363636363636,63.0,3,3,5,0,11
83571,96.0,96.0,96.0,0,0,1,0,1
83572,87.0,87.0,87.0,2,2,2,0,6
83575,84.0,84.5,83.0,4,3,3,0,10
83587,100.0,100.0,100.0,0,0,0,3,3
83588,88.0,88.28571428571429,86.0,0,5,9,0,14
83596,81.0,81.0,81.0,1,0,3,0,4
83603,88.0,88.85714285714286,88.0,0,3,4,0,7
83610,100.0,100.0,100.0,0,0,0,1,1
83627,90.0,92.5,90.0,0,1,2,1,4
83633,87.0,86.5,83.0,4,4,4,0,12
83640,90.0,90.44444444444444,90.0,0,4,5,0,9
83642,88.0,86.18181818181819,80.0,2,5,4,0,11
83643,87.0,87.5,86.0,1,3,6,0,10
83644,79.0,79.0,79.0,1,1,3,0,5
83648,84.0,84.11111111111111,78.0,2,8,8,0,18
83655,87.0,87.7,85.0,2,5,3,0,10
83687,89.5,89.5,87.0,1,3,2,0,6
83704,86.0,85.92857142857143,81.0,1,9,4,0,14
83709,83.0,84.875,83.0,1,3,4,0,8
83711,96.0,96.66666666666667,96.0,0,3,0,0,3
83744,87.0,88.66666666666667,87.0,3,3,2,0,8
83755,80.0,88.0,80.0,2,1,2,2,7
83769,95.0,95.0,94.0,0,3,1,0,4
83773,80.0,82.66666666666667,80.0,0,1,8,0,9
83799,85.0,82.05882352941177,76.0,4,6,7,0,17
83804,86.0,85.41666666666667,81.0,1,5,6,0,12
83808,77.0,79.3076923076923,77.0,1,7,5,0,13
83822,92.0,91.33333333333333,90.0,0,5,4,0,9
83824,88.0,90.57142857142857,88.0,0,5,2,0,7
83841,81.0,83.53333333333333,79.0,3,6,6,0,15
83843,100.0,99.33333333333333,98.0,0,1,0,2,3
83889,92.0,94.4,92.0,0,4,1,0,5
83927,97.0,97.0,94.0,0,1,1,2,4
83945,94.0,94.0,92.0,0,2,2,0,4
83953,93.5,91.25,87.0,2,3,3,0,8
83968,94.0,96.0,94.0,0,1,1,1,3
83969,96.0,96.0,96.0,0,0,1,0,1
83971,92.0,92.0,92.0,0,0,2,0,2
83990,92.0,91.8,90.0,0,8,2,0,10
83994,86.0,86.0,86.0,0,3,2,0,5
83995,86.0,88.66666666666667,86.0,0,2,4,0,6
83998,92.0,92.33333333333333,91.0,1,2,3,0,6
84038,76.5,76.5,75.0,5,0,3,0,8
84040,86.0,87.2,82.0,0,4,6,0,10
84065,92.0,92.0,92.0,0,2,3,0,5
84095,87.0,90.25,87.0,1,1,1,1,4
84103,90.0,90.0,90.0,0,4,3,0,7
84109,90.0,90.4,88.0,0,2,7,1,10
84124,80.0,79.81818181818181,76.0,5,2,4,0,11
84130,98.0,98.0,98.0,0,1,0,0,1
84165,81.5,82.35714285714286,77.0,1,7,6,0,14
84171,82.0,85.55555555555556,82.0,0,4,5,0,9
84196,88.0,90.0,88.0,0,3,3,0,6
84205,87.0,88.3,85.0,2,6,2,0,10
84256,87.5,87.625,83.0,2,3,3,0,8
84339,100.0,100.0,100.0,0,0,0,2,2
84389,98.0,98.0,98.0,0,3,0,0,3
84394,88.0,88.0,86.0,0,12,3,0,15
84417,90.0,89.72727272727273,87.0,2,6,3,0,11
84418,77.0,77.0,77.0,1,2,3,0,6
84451,99.0,99.0,98.0,0,1,0,1,2
84453,87.0,87.0,87.0,1,1,1,0,3
84456,94.0,94.0,94.0,0,1,1,0,2
84469,84.0,78.95454545454545,69.0,2,13,7,0,22
84500,87.0,90.6,87.0,1,1,3,0,5
84502,100.0,100.0,100.0,0,0,0,1,1
84518,96.0,96.0,96.0,0,2,0,0,2
84533,83.0,84.58823529411765,81.0,3,7,7,0,17
84541,94.0,93.6,92.0,0,1,4,0,5
84543,86.5,87.0,85.0,2,9,5,0,16
84547,86.0,86.88888888888889,86.0,0,5,4,0,9
84548,81.0,80.46153846153847,78.0,4,3,6,0,13
84551,100.0,100.0,100.0,0,0,0,1,1
84582,86.0,86.0,85.0,2,8,3,0,13
84589,91.0,91.0,91.0,1,1,0,0,2
84590,54.0,54.0,54.0,4,3,3,0,10
84615,88.0,89.0909090909091,88.0,0,6,5,0,11
84619,92.0,92.8,92.0,0,3,2,0,5
84629,100.0,100.0,100.0,0,0,0,2,2
84634,87.0,89.4,87.0,3,1,1,0,5
84656,78.0,77.57142857142857,77.0,1,7,6,0,14
84657,94.0,94.0,94.0,0,2,2,0,4
84690,96.0,95.6,94.0,0,4,1,0,5
84708,92.0,92.0,86.0,0,1,0,1,2
84711,92.0,88.08333333333333,81.0,1,6,5,0,12
84715,97.0,97.0,94.0,0,1,1,2,4
84729,93.0,93.0,93.0,1,0,0,0,1
84735,90.0,90.0,90.0,0,3,1,0,4
84749,100.0,100.0,100.0,0,0,0,2,2
84770,92.0,93.6,92.0,0,4,1,0,5
84813,84.0,86.57142857142857,84.0,0,1,6,0,7
84856,94.0,95.33333333333333,94.0,0,2,1,0,3
84863,74.0,77.0625,74.0,3,5,8,0,16
84865,87.0,87.0,86.0,0,3,5,0,8
84887,70.0,72.5,70.0,4,3,5,0,12
84888,96.0,97.0,96.0,0,0,3,1,4
84889,86.5,86.04545454545455,81.0,2,14,6,0,22
84892,94.0,94.66666666666667,94.0,0,5,1,0,6
84910,94.0,94.75,93.0,1,2,1,0,4
84911,91.0,91.5,90.0,0,4,4,0,8
84921,96.0,96.66666666666667,96.0,0,3,0,0,3
84971,81.0,84.0,81.0,2,4,2,0,8
84982,96.0,96.0,96.0,0,0,1,0,1
84983,96.0,94.33333333333333,91.0,1,5,0,0,6
85007,92.0,92.0,92.0,0,4,4,0,8
85047,100.0,98.66666666666667,96.0,0,0,1,2,3
85063,100.0,100.0,100.0,0,0,0,2,2
85078,100.0,100.0,100.0,0,0,0,1,1
85091,98.0,98.0,98.0,0,2,0,1,3
85095,85.0,84.16666666666667,80.0,3,6,3,0,12
85097,97.0,97.0,96.0,0,1,1,0,2
85144,91.0,92.66666666666667,91.0,1,1,1,0,3
85156,100.0,100.0,100.0,0,0,0,2,2
85157,79.0,83.0,79.0,1,3,5,0,9
85158,93.0,94.0,92.0,0,3,2,1,6
85159,94.0,92.33333333333333,89.0,1,2,3,0,6
85164,87.5,87.5,85.0,1,5,2,0,8
85166,76.0,79.73913043478261,70.0,5,11,7,0,23
85169,92.5,92.0,89.0,2,3,3,0,8
85170,99.0,99.0,98.0,0,1,0,1,2
85183,88.0,89.14285714285714,88.0,0,4,3,0,7
85185,90.0,89.27272727272727,88.0,0,6,5,0,11
85221,96.0,96.66666666666667,96.0,0,3,0,0,3
85258,82.0,82.0,82.0,2,2,0,0,4
85271,84.0,86.0,84.0,0,5,2,0,7
85279,88.0,90.4,88.0,0,1,4,0,5
85295,71.0,70.8695652173913,66.0,4,9,10,0,23
85299,86.0,86.0,86.0,0,1,3,0,4
85307,88.5,88.5,87.0,1,2,3,0,6
85310,88.5,88.5,87.0,1,2,3,0,6
85327,90.0,88.28571428571429,84.0,0,5,9,0,14
85333,89.0,90.0,87.0,2,6,1,0,9
85337,90.0,90.0,90.0,0,3,1,0,4
85342,98.0,98.0,96.0,0,0,1,1,2
85363,85.0,85.83333333333333,82.0,1,3,8,0,12
85377,88.0,88.33333333333333,88.0,1,2,3,0,6
85397,92.0,92.0,92.0,0,4,0,0,4
85430,100.0,100.0,100.0,0,0,0,2,2
85433,91.5,91.83333333333333,87.0,1,4,1,0,6
85459,94.0,94.0,94.0,0,3,0,0,3
85480,94.0,92.8,91.0,1,4,0,0,5
85495,93.5,93.5,87.0,1,1,1,3,6
85500,89.0,89.42857142857143,88.0,0,7,7,0,14
85501,91.5,91.83333333333333,90.0,1,2,3,0,6
85518,94.0,94.75,93.0,1,2,1,0,4
85525,88.0,90.85714285714286,88.0,0,3,4,0,7
85532,87.0,87.0,87.0,1,1,1,0,3
85541,96.0,96.0,94.0,0,3,1,1,5
85562,70.0,70.93333333333334,70.0,4,7,4,0,15
85578,83.0,84.71428571428571,83.0,2,2,3,0,7
85583,94.0,92.5,90.0,0,5,3,0,8
85594,92.0,94.0,92.0,0,1,2,0,3
85646,100.0,100.0,100.0,0,0,0,3,3
85670,95.0,95.5,92.0,0,1,2,1,4
85679,94.0,90.14285714285714,85.0,1,2,4,0,7
85680,94.0,95.25,93.0,1,1,1,1,4
85682,97.0,97.0,94.0,0,1,1,2,4
85683,92.0,94.0,92.0,0,2,2,2,6
85694,92.0,92.8,92.0,0,4,1,0,5
85696,88.0,88.77777777777777,86.0,0,11,7,0,18
85713,99.0,99.0,98.0,0,1,0,1,2
85714,77.0,78.25,77.0,2,11,7,0,20
85722,83.0,83.0,83.0,1,3,1,0,5
85766,94.0,93.66666666666667,89.0,1,3,2,0,6
85779,92.0,93.33333333333333,92.0,0,2,4,0,6
85781,86.0,84.6,81.0,2,10,3,0,15
85787,70.0,74.58333333333333,70.0,3,4,5,0,12
85809,90.0,92.0,90.0,0,5,1,0,6
85816,100.0,100.0,100.0,0,0,0,1,1
85824,85.0,84.46153846153847,82.0,2,6,5,0,13
85835,76.0,75.1875,69.0,6,6,4,0,16
85843,85.5,85.5,83.0,1,3,4,0,8
85849,82.0,82.0,82.0,0,5,2,0,7
85898,96.0,97.33333333333333,96.0,0,2,0,1,3
85917,88.0,88.5,82.0,2,5,1,0,8
85924,90.0,89.05882352941177,88.0,0,12,5,0,17
85925,72.0,74.6923076923077,72.0,1,3,9,0,13
85927,90.0,89.55555555555556,86.0,0,4,5,0,9
85930,88.5,88.5,85.0,1,2,3,0,6
85933,100.0,98.66666666666667,96.0,0,0,1,2,3
85935,100.0,98.66666666666667,96.0,0,0,1,2,3
85936,85.0,90.2,85.0,1,0,3,1,5
85937,100.0,99.33333333333333,98.0,0,1,0,2,3
85938,99.0,99.0,98.0,0,1,0,1,2
85944,92.0,92.28571428571429,89.0,1,4,2,0,7
85947,84.0,80.0,75.0,3,2,4,0,9
85953,85.0,83.9090909090909,78.0,5,0,6,0,11
85955,83.0,85.15789473684211,81.0,2,12,5,0,19
85971,98.0,98.0,98.0,0,3,0,0,3
85986,77.0,79.4,77.0,2,3,5,0,10
85987,95.0,95.0,94.0,0,3,1,0,4
86002,88.0,86.13333333333334,82.0,0,10,5,0,15
86013,88.0,88.06666666666666,87.0,2,9,4,0,15
86071,100.0,100.0,100.0,0,0,0,2,2
86073,90.0,90.44444444444444,89.0,1,5,3,0,9
86074,97.0,97.0,96.0,0,1,1,0,2
86076,80.0,79.28,73.0,3,14,8,0,25
86110,96.0,96.0,94.0,0,3,1,0,4
86116,94.0,93.8,91.0,1,9,0,0,10
86117,96.0,96.66666666666667,96.0,0,3,0,0,3
86124,92.0,92.85714285714286,92.0,0,5,2,0,7
86133,91.0,91.0,90.0,0,3,3,0,6
86137,90.0,93.28571428571429,90.0,1,3,1,2,7
86138,67.0,74.5,67.0,5,3,4,0,12
86144,98.0,98.0,96.0,0,2,0,2,4
86149,86.0,86.16666666666667,82.0,2,7,3,0,12
86150,83.0,84.3076923076923,81.0,2,7,4,0,13
86152,90.0,87.6923076923077,83.0,1,12,0,0,13
86154,88.0,91.14285714285714,88.0,0,4,3,0,7
86156,95.0,95.0,94.0,0,3,1,0,4
86158,94.0,95.2,94.0,0,2,2,1,5
86160,86.0,85.45454545454545,83.0,1,2,8,0,11
86161,97.0,97.0,94.0,0,1,1,2,4
86162,91.0,91.0,91.0,1,1,0,0,2
86166,84.0,84.0,84.0,0,4,2,0,6
86168,73.0,77.68181818181819,72.0,4,11,7,0,22
86170,86.0,82.44444444444444,78.0,2,3,4,0,9
86178,98.0,98.0,98.0,0,1,0,0,1
86180,84.0,82.4,78.0,0,14,6,0,20
86224,72.0,72.0,72.0,2,5,1,0,8
86231,88.0,89.29411764705883,88.0,0,13,4,0,17
86238,100.0,100.0,100.0,0,0,0,2,2
86261,83.0,78.61538461538461,67.0,4,3,6,0,13
86271,80.0,83.08333333333333,80.0,1,5,6,0,12
86282,80.0,80.0,80.0,2,1,1,0,4
86283,86.0,86.0,86.0,0,3,2,0,5
86284,84.0,83.0,78.0,2,6,6,0,14
86294,90.0,91.71428571428571,90.0,0,6,1,0,7
86296,84.0,86.66666666666667,84.0,0,5,4,0,9
86301,90.0,91.9090909090909,87.0,1,6,4,0,11
86310,100.0,100.0,100.0,0,0,0,1,1
86333,96.0,96.0,96.0,0,2,0,0,2
86336,96.0,94.0,90.0,0,5,2,0,7
86344,100.0,100.0,100.0,0,0,0,2,2
86354,96.0,96.0,94.0,0,3,1,0,4
86358,88.5,88.5,87.0,1,2,3,0,6
86359,87.0,85.125,79.0,2,10,4,0,16
86362,88.0,88.0,88.0,0,0,3,0,3
86381,92.0,93.14285714285714,90.0,0,2,4,1,7
86384,85.0,85.25,85.0,1,0,2,1,4
86385,93.0,93.0,93.0,1,0,0,0,1
86386,92.0,92.28571428571429,91.0,1,4,2,0,7
86394,94.0,94.0,94.0,0,1,1,0,2
86404,90.0,91.8,90.0,1,1,3,0,5
86406,90.0,90.5,87.0,1,5,4,0,10
86407,96.0,96.0,96.0,0,2,2,0,4
86409,100.0,100.0,100.0,0,0,0,3,3
86423,86.0,86.88888888888889,86.0,0,5,4,0,9
86470,92.0,92.0,92.0,0,2,1,0,3
86475,85.5,85.5,85.0,1,3,4,0,8
86478,100.0,100.0,100.0,0,0,0,1,1
86480,79.0,83.0909090909091,79.0,1,7,3,0,11
86484,82.0,82.0,82.0,2,0,1,0,3
86485,94.0,94.0,94.0,0,1,1,0,2
86486,93.0,93.5,92.0,0,7,1,0,8
86539,85.0,84.38461538461539,76.0,3,4,6,0,13
86545,86.0,84.28571428571429,82.0,2,1,4,0,7
86555,79.0,82.5,75.0,4,3,7,0,14
86561,89.5,88.64285714285714,83.0,2,5,7,0,14
86564,90.0,88.72727272727273,85.0,1,7,3,0,11
86567,85.0,85.0,85.0,1,2,1,0,4
86568,89.0,91.0,89.0,1,3,1,0,5
86588,94.0,94.0,94.0,0,1,1,0,2
86593,90.0,90.0,90.0,0,1,2,0,3
86629,88.0,88.75,88.0,0,5,3,0,8
86645,79.0,81.1875,79.0,2,7,7,0,16
86647,72.0,72.0,72.0,4,2,6,0,12
86652,98.0,98.0,98.0,0,2,0,0,2
86653,95.0,96.0,94.0,0,1,2,1,4
86658,86.0,85.18181818181819,80.0,0,16,6,0,22
86659,90.0,90.0,90.0,0,2,4,0,6
86670,75.0,75.0,75.0,2,6,6,0,14
86694,86.0,83.41666666666667,78.0,3,5,4,0,12
86715,91.0,92.8,91.0,2,2,0,1,5
86718,45.0,61.578947368421055,45.0,5,8,6,0,19
86742,89.0,89.0,89.0,1,0,1,0,2
86753,96.0,95.66666666666667,93.0,1,1,1,0,3
86765,88.0,85.28571428571429,79.0,1,9,4,0,14
86766,92.0,91.71428571428571,90.0,0,2,5,0,7
86768,100.0,98.66666666666667,96.0,0,0,1,2,3
86774,92.5,92.5,89.0,1,2,1,0,4
86780,92.0,91.71428571428571,90.0,0,3,4,0,7
86781,94.0,92.85714285714286,90.0,0,5,2,0,7
86807,88.5,88.5,87.0,1,2,3,0,6
86814,92.0,92.0,92.0,0,2,5,0,7
86816,94.0,94.8,94.0,0,5,0,0,5
86829,86.0,86.88888888888889,86.0,0,5,4,0,9
86845,74.0,80.92307692307692,74.0,0,5,8,0,13
86868,75.0,80.0,75.0,1,2,6,0,9
86885,89.0,90.16666666666667,87.0,2,3,1,0,6
86910,94.0,94.5,92.0,0,1,3,0,4
86924,86.5,86.5,85.0,1,0,5,0,6
86933,90.0,92.2,90.0,1,2,2,0,5
86960,98.0,98.0,96.0,0,0,1,1,2
86986,99.0,99.0,98.0,0,1,0,1,2
86990,83.0,81.73333333333333,78.0,3,7,5,0,15
86991,96.0,96.0,92.0,0,0,2,2,4
86992,95.0,95.5,92.0,0,1,2,1,4
86994,98.0,98.0,96.0,0,1,1,1,3
86997,92.0,91.66666666666667,89.0,1,2,3,0,6
87015,77.0,77.0,77.0,1,2,3,0,6
87044,90.0,89.27272727272727,88.0,0,6,5,0,11
87048,89.0,89.8,89.0,2,3,0,0,5
87050,89.0,89.0,88.0,0,5,3,0,8
87079,92.0,93.33333333333333,92.0,0,2,4,0,6
87097,96.0,96.66666666666667,96.0,0,3,0,0,3
87099,85.0,85.58333333333333,81.0,2,7,3,0,12
87107,89.0,88.9,88.0,1,5,4,0,10
87112,96.0,96.8,96.0,0,4,0,1,5
87122,98.0,97.33333333333333,96.0,0,2,1,0,3
87149,98.0,98.66666666666667,98.0,0,2,0,1,3
87154,92.0,92.22222222222223,88.0,0,5,4,0,9
87167,88.0,83.71428571428571,77.0,1,7,6,0,14
87200,98.0,98.66666666666667,98.0,0,2,0,1,3
87201,86.0,86.0,86.0,0,3,2,0,5
87202,93.0,94.0,92.0,0,3,2,1,6
87203,90.0,89.0,87.0,1,3,5,0,9
87209,94.0,94.85714285714286,92.0,0,3,2,2,7
87258,92.0,92.8,92.0,0,4,1,0,5
87260,94.0,95.2,94.0,0,4,1,0,5
87272,90.0,91.5,90.0,0,3,3,0,6
87281,89.0,89.0,86.0,0,5,5,0,10
87285,86.0,87.0,82.0,0,7,5,0,12
87298,84.0,84.0,84.0,2,1,0,0,3
87309,97.0,97.0,94.0,0,1,1,2,4
87327,86.0,88.0,86.0,0,1,4,0,5
87338,84.0,84.0,84.0,0,0,4,0,4
87339,88.0,90.0,88.0,0,0,4,0,4
87401,92.0,92.0,92.0,0,0,2,0,2
87404,96.0,96.66666666666667,96.0,0,1,2,0,3
87425,87.0,87.3,82.0,3,2,5,0,10
87440,86.0,85.66666666666667,84.0,1,5,6,0,12
87443,84.0,85.77777777777777,84.0,0,4,5,0,9
87447,76.0,77.86666666666666,74.0,4,4,7,0,15
87482,83.0,84.23076923076923,83.0,3,7,3,0,13
87492,90.0,90.0,90.0,0,3,1,0,4
87511,74.0,71.57894736842105,65.0,4,4,11,0,19
87517,81.0,78.38888888888889,69.0,4,10,4,0,18
87537,93.5,94.5,91.0,1,1,1,1,4
87539,88.0,88.9,87.0,1,5,4,0,10
87551,74.0,74.85714285714286,72.0,6,1,7,0,14
87552,74.0,76.375,74.0,4,8,4,0,16
87556,92.5,93.5,89.0,1,0,2,1,4
87594,83.0,76.26666666666667,68.0,3,2,10,0,15
87604,94.0,95.2,94.0,0,2,2,1,5
87605,94.0,94.0,94.0,0,1,1,0,2
87609,100.0,98.66666666666667,96.0,0,0,1,2,3
87613,85.0,84.84615384615384,83.0,3,8,2,0,13
87624,92.5,94.25,92.0,1,0,2,1,4
87628,62.0,69.27272727272727,62.0,4,1,6,0,11
87631,94.0,95.42857142857143,94.0,0,5,1,1,7
87634,98.0,98.0,98.0,0,1,0,0,1
87639,85.0,83.23076923076923,78.0,3,6,4,0,13
87645,98.0,98.66666666666667,98.0,0,2,0,1,3
87647,85.0,86.0,83.0,2,9,1,0,12
87648,86.0,88.66666666666667,86.0,0,2,4,0,6
87652,91.0,91.0,91.0,1,1,0,0,2
87677,80.0,80.0,80.0,2,1,1,0,4
87693,98.0,98.0,98.0,0,2,0,0,2
87699,97.0,97.0,96.0,0,2,2,0,4
87700,94.0,92.0909090909091,89.0,2,9,0,0,11
87709,72.0,72.0,72.0,2,3,2,0,7
87714,83.0,85.14285714285714,83.0,1,1,5,0,7
87742,100.0,100.0,100.0,0,0,0,1,1
87757,97.0,97.0,96.0,0,1,1,0,2
87765,79.0,81.8,79.0,1,4,5,0,10
87778,86.0,89.0909090909091,86.0,0,8,3,0,11
87780,86.0,86.5,83.0,1,7,8,0,16
87782,96.0,95.75,93.0,1,3,0,0,4
87791,71.5,71.5,70.0,3,4,7,0,14
87799,83.0,83.0,83.0,1,1,2,0,4
87814,90.0,90.0,89.0,2,1,1,0,4
87889,94.0,93.2,92.0,0,3,2,0,5
87909,96.0,96.0,96.0,0,0,1,0,1
87924,75.0,77.66666666666667,75.0,2,6,4,0,12
87927,87.0,89.8,87.0,1,2,2,0,5
87932,92.0,92.0,90.0,0,2,6,0,8
87951,82.0,82.3529411764706,81.0,2,11,4,0,17
87952,84.0,84.0,83.0,2,3,3,0,8
87953,98.0,97.33333333333333,96.0,0,2,1,0,3
87954,91.0,91.0,91.0,1,1,0,0,2
88058,81.0,83.71428571428571,81.0,1,4,1,1,7
88063,84.0,82.11764705882354,73.0,4,8,5,0,17
88066,90.0,86.42857142857143,79.0,3,2,2,0,7
88082,80.0,80.0,74.0,2,7,3,0,12
88085,89.0,89.0,89.0,1,0,1,0,2
88087,82.0,85.25,82.0,6,5,1,0,12
88090,88.0,86.66666666666667,80.0,0,4,1,1,6
88091,89.0,89.0,89.0,1,2,0,0,3
88099,90.0,92.0,90.0,0,2,2,0,4
88100,94.0,94.8,94.0,0,3,2,0,5
88105,100.0,100.0,100.0,0,0,0,2,2
88113,87.0,87.33333333333333,85.0,2,2,5,0,9
88115,97.0,97.0,94.0,0,1,1,2,4
88119,94.0,94.0,94.0,0,5,2,0,7
88120,93.0,93.33333333333333,90.0,0,4,2,0,6
88129,72.0,78.15384615384616,72.0,2,9,2,0,13
88133,89.0,92.66666666666667,89.0,1,0,1,1,3
88134,82.0,88.0,82.0,2,1,2,0,5
88146,100.0,100.0,100.0,0,0,0,1,1
88159,86.0,87.33333333333333,86.0,0,6,3,0,9
88202,94.0,94.0,92.0,0,0,4,0,4
88264,92.0,91.71428571428571,90.0,0,2,5,0,7
88281,96.0,96.0,96.0,0,0,1,0,1
88326,88.0,88.0,85.0,4,3,9,0,16
88339,88.0,88.0,88.0,0,0,3,0,3
88340,84.0,81.54545454545455,75.0,1,13,8,0,22
88342,96.0,96.0,96.0,0,0,1,0,1
88380,100.0,99.33333333333333,98.0,0,1,0,2,3
88381,98.0,98.66666666666667,98.0,0,2,0,1,3
88382,90.0,90.375,87.0,1,4,3,0,8
88388,87.0,89.25,87.0,1,1,2,0,4
88428,90.0,90.0,90.0,0,7,4,0,11
88433,80.0,83.2,80.0,2,1,2,0,5
88443,89.0,89.0,89.0,1,0,1,0,2
88459,86.0,89.0,86.0,1,4,2,1,8
88461,90.5,90.5,85.0,1,6,1,0,8
88470,88.0,90.28571428571429,88.0,0,4,3,0,7
88475,83.0,86.0,83.0,1,1,4,0,6
88488,74.0,74.3529411764706,74.0,5,3,9,0,17
88498,100.0,99.33333333333333,98.0,0,1,0,2,3
88500,96.0,96.0,96.0,0,0,1,0,1
88508,92.0,91.9,89.0,1,6,3,0,10
88525,94.0,92.625,89.0,1,7,0,0,8
88539,90.0,91.4,90.0,0,4,5,1,10
88554,83.0,83.1875,79.0,4,5,7,0,16
88574,86.0,89.33333333333333,86.0,0,3,3,0,6
88577,71.0,76.0,71.0,4,3,1,0,8
88675,88.0,90.66666666666667,88.0,0,4,2,0,6
88676,90.0,90.0,86.0,2,1,1,0,4
88688,88.0,88.23076923076923,85.0,1,4,8,0,13
88690,88.0,89.125,87.0,1,2,5,0,8
88708,100.0,100.0,100.0,0,0,0,3,3
88718,89.0,90.0,86.0,3,0,1,1,5
88721,92.0,92.0,92.0,0,2,1,0,3
88722,94.0,94.0,92.0,0,9,0,0,9
88723,82.0,84.0,80.0,4,2,1,1,8
88741,92.0,92.0,92.0,0,0,2,0,2
88756,82.0,80.10344827586206,73.0,2,13,14,0,29
88759,98.0,98.0,98.0,0,2,0,0,2
88774,98.0,98.0,96.0,0,2,0,2,4
88799,83.0,82.07692307692308,79.0,3,4,6,0,13
88802,96.0,96.0,96.0,0,0,1,0,1
88821,94.0,94.0,94.0,0,1,1,0,2
88829,100.0,100.0,100.0,0,0,0,1,1
88831,92.0,90.5,86.0,2,4,2,0,8
88862,94.0,89.9090909090909,83.0,1,7,3,0,11
88872,99.0,99.0,98.0,0,1,0,1,2
88873,90.0,90.0,88.0,0,6,4,0,10
88878,96.0,96.0,96.0,0,2,1,0,3
88883,82.5,83.5,78.0,3,3,4,0,10
88910,94.0,93.66666666666667,91.0,1,4,1,0,6
88942,87.0,87.66666666666667,82.0,2,0,4,0,6
88954,92.0,93.0,91.0,2,3,2,0,7
88955,87.0,87.0,87.0,1,1,1,0,3
88975,83.0,83.77777777777777,81.0,2,7,9,0,18
88983,98.0,98.0,96.0,0,0,1,1,2
89025,83.0,80.52941176470588,72.0,5,6,6,0,17
89027,90.0,90.85714285714286,90.0,0,5,2,0,7
89069,83.0,85.0909090909091,82.0,3,5,3,0,11
89070,62.0,64.05882352941177,62.0,5,6,6,0,17
89071,84.0,84.38461538461539,83.0,3,7,3,0,13
89072,84.0,84.47368421052632,80.0,7,8,4,0,19
89076,100.0,100.0,100.0,0,0,0,1,1
89080,90.5,90.5,89.0,1,0,3,0,4
89086,92.0,90.9,87.0,1,4,5,0,10
89104,78.0,81.6470588235294,78.0,1,12,4,0,17
89114,88.0,87.41666666666667,86.0,1,7,4,0,12
89115,66.0,75.6,66.0,2,7,6,0,15
89127,81.0,78.46666666666667,74.0,5,6,4,0,15
89128,90.0,88.72727272727273,86.0,0,6,5,0,11
89130,83.0,83.3157894736842,78.0,6,6,7,0,19
89133,91.0,91.33333333333333,88.0,0,1,5,0,6
89138,100.0,100.0,100.0,0,0,0,3,3
89140,100.0,100.0,100.0,0,0,0,2,2
89141,60.0,65.0,60.0,7,3,3,0,13
89143,92.0,92.5,92.0,0,5,3,0,8
89167,90.0,87.0,83.0,2,7,2,0,11
89188,97.0,97.0,96.0,0,1,1,0,2
89191,94.0,94.66666666666667,94.0,0,1,2,0,3
89193,87.0,87.0,87.0,1,1,1,0,3
89194,96.0,96.5,96.0,0,3,1,0,4
89196,90.0,90.85714285714286,90.0,0,5,2,0,7
89213,96.0,97.33333333333333,96.0,0,0,2,1,3
89276,89.0,89.0,88.0,0,5,3,0,8
89292,100.0,100.0,100.0,0,0,0,1,1
89315,89.0,90.0,88.0,1,1,5,0,7
89322,100.0,100.0,100.0,0,0,0,3,3
89324,76.0,81.33333333333333,76.0,2,3,4,0,9
89328,90.0,92.4,90.0,0,3,2,0,5
89335,79.0,80.0909090909091,79.0,3,7,1,0,11
89336,91.0,92.75,89.0,2,0,1,1,4
89385,90.0,90.0,90.0,0,1,2,0,3
89404,90.0,91.71428571428571,90.0,0,6,1,0,7
89416,94.0,95.4,93.0,1,3,1,0,5
89447,100.0,100.0,100.0,0,0,0,1,1
89449,88.0,88.0,88.0,0,4,1,1,6
89453,81.0,84.6,81.0,1,7,2,0,10
89462,76.0,77.77777777777777,76.0,4,2,3,0,9
89464,98.0,98.0,98.0,0,1,0,0,1
89475,93.0,93.0,92.0,0,1,3,0,4
89495,96.0,93.875,89.0,1,6,0,1,8
89497,77.0,79.72727272727273,77.0,2,7,2,0,11
89511,100.0,99.5,98.0,0,1,0,3,4
89512,100.0,98.25,93.0,1,0,0,3,4
89515,96.0,96.0,96.0,0,0,3,0,3
89544,88.5,88.5,87.0,1,6,1,0,8
89559,90.0,92.4,90.0,0,3,2,0,5
89560,98.0,98.0,96.0,0,1,1,1,3
89567,100.0,100.0,100.0,0,0,0,1,1
89569,80.0,84.2,80.0,0,3,7,0,10
89580,89.0,89.0,89.0,1,0,1,0,2
89590,90.0,87.11111111111111,83.0,2,3,4,0,9
89594,91.5,91.5,89.0,1,1,2,0,4
89599,92.0,89.33333333333333,85.0,1,5,3,0,9
89640,94.0,96.0,94.0,0,1,1,1,3
89643,93.0,93.4,92.0,0,5,5,0,10
89648,83.0,82.57142857142857,82.0,3,1,3,0,7
89652,98.0,98.0,98.0,0,1,0,0,1
89653,98.0,98.0,96.0,0,0,1,1,2
89654,98.0,98.0,98.0,0,1,0,0,1
89663,92.0,92.0,92.0,0,2,1,0,3
89666,100.0,100.0,100.0,0,0,0,1,1
89682,96.0,96.5,96.0,0,3,1,0,4
89685,96.0,96.0,96.0,0,0,1,0,1
89687,89.0,89.63157894736842,88.0,1,14,4,0,19
89694,94.0,95.0,92.0,0,0,3,1,4
89696,87.0,90.6,87.0,1,1,3,0,5
89701,100.0,98.6,93.0,1,0,0,4,5
89722,92.0,92.0,92.0,0,2,1,0,3
89728,91.0,90.85714285714286,89.0,2,3,2,0,7
89733,78.0,78.0,75.0,4,0,4,0,8
89748,93.0,95.33333333333333,93.0,2,0,0,1,3
89751,86.0,84.18181818181819,78.0,2,2,7,0,11
89758,82.0,82.41176470588235,81.0,4,5,8,0,17
89765,92.0,92.0,92.0,0,3,1,0,4
89772,92.0,93.16666666666667,92.0,1,5,0,0,6
89773,88.0,88.4,84.0,0,5,5,0,10
89775,91.0,91.0,91.0,2,2,0,0,4
89789,90.0,90.14285714285714,87.0,1,2,3,1,7
89798,82.0,83.6,82.0,0,4,6,0,10
89803,88.0,89.5,88.0,0,2,5,1,8
89830,84.0,86.66666666666667,84.0,0,5,4,0,9
89847,87.0,87.0,87.0,1,1,1,0,3
89865,94.0,94.0,94.0,0,3,0,0,3
89909,88.0,88.0,88.0,0,0,3,0,3
89920,90.0,92.33333333333333,90.0,0,4,2,0,6
89922,92.0,92.0,90.0,0,9,1,0,10
89927,100.0,97.66666666666667,93.0,1,0,0,2,3
89931,99.0,99.0,98.0,0,1,0,1,2
89948,83.0,83.0,83.0,1,1,2,0,4
89952,87.0,87.0,87.0,1,1,1,0,3
89968,98.0,98.0,98.0,0,1,0,0,1
89969,92.0,92.0,92.0,0,2,1,0,3
89981,79.0,79.0,79.0,1,3,2,0,6
89982,81.0,78.8,71.0,4,7,4,0,15
89988,95.0,95.0,94.0,0,3,1,0,4
89993,79.0,80.5,76.0,3,4,7,0,14
90008,89.0,89.0,87.0,3,5,0,0,8
90010,94.0,94.28571428571429,92.0,0,3,3,1,7
90015,86.0,89.66666666666667,86.0,0,2,4,0,6
90030,88.0,88.0,88.0,0,2,2,0,4
90039,85.5,86.3,81.0,1,4,5,0,10
90040,94.0,91.77777777777777,88.0,0,7,2,0,9
90041,99.0,97.66666666666667,94.0,0,2,1,3,6
90060,96.0,96.0,96.0,0,4,0,0,4
90067,89.0,89.88888888888889,85.0,2,2,4,1,9
90110,90.0,90.0,90.0,0,1,2,0,3
90114,98.0,98.0,98.0,0,2,0,0,2
90137,80.0,87.71428571428571,80.0,2,2,2,1,7
90139,83.5,83.5,81.0,1,1,6,0,8
90147,94.0,94.0,94.0,0,1,1,0,2
90149,94.0,94.0,94.0,0,2,2,0,4
90150,83.0,86.4,83.0,1,1,2,1,5
90192,81.0,80.92307692307692,79.0,4,4,5,0,13
90203,90.0,90.0,90.0,0,2,3,0,5
90212,81.0,83.21428571428571,80.0,3,8,3,0,14
90214,89.0,86.5,82.0,3,5,2,0,10
90217,90.0,89.125,87.0,2,3,3,0,8
90221,81.0,82.5,81.0,3,3,6,0,12
90222,94.0,94.0,94.0,0,1,1,0,2
90233,96.0,95.71428571428571,94.0,0,6,1,0,7
90234,100.0,97.33333333333333,92.0,0,0,2,4,6
90236,74.5,75.625,63.0,3,7,6,0,16
90237,83.0,84.33333333333333,83.0,1,4,4,0,9
90238,73.0,74.23809523809524,71.0,2,11,8,0,21
90239,72.0,79.38461538461539,72.0,2,3,8,0,13
90256,90.0,88.36363636363636,84.0,2,7,2,0,11
90268,98.0,98.0,96.0,0,0,2,2,4
90269,99.0,98.5,96.0,0,1,1,2,4
90272,89.0,86.75,80.0,2,5,1,0,8
90273,99.0,99.0,98.0,0,1,0,1,2
90281,96.0,96.0,96.0,0,0,1,0,1
90285,95.0,96.0,94.0,0,1,2,1,4
90310,100.0,99.33333333333333,98.0,0,1,0,2,3
90313,92.0,91.42857142857143,86.0,2,4,1,0,7
90316,93.5,93.5,91.0,1,3,0,0,4
90330,100.0,100.0,100.0,0,0,0,1,1
90331,90.0,90.0,90.0,0,2,4,0,6
90341,92.0,92.0,92.0,0,0,2,0,2
90343,99.0,99.0,98.0,0,1,0,1,2
90344,99.0,99.0,98.0,0,1,0,1,2
90352,99.0,99.0,98.0,0,1,0,1,2
90378,93.0,93.0,92.0,0,5,1,0,6
90409,92.0,92.8,92.0,0,3,2,0,5
90417,92.0,92.33333333333333,92.0,1,0,2,0,3
90427,90.0,89.375,87.0,1,2,5,0,8
90428,84.0,86.85714285714286,84.0,0,3,4,0,7
90436,100.0,100.0,100.0,0,0,0,2,2
90437,94.0,96.0,94.0,0,1,1,1,3
90439,100.0,100.0,100.0,0,0,0,2,2
90448,76.0,74.0,65.0,5,9,5,0,19
90449,85.0,88.66666666666667,85.0,1,4,1,0,6
90458,91.0,92.66666666666667,91.0,1,1,1,0,3
90460,85.0,87.61538461538461,85.0,2,6,5,0,13
90461,90.0,90.0,90.0,0,6,2,0,8
90464,100.0,100.0,100.0,0,0,0,1,1
90482,90.0,90.0,90.0,0,1,2,0,3
90486,95.0,95.0,94.0,0,3,1,0,4
90487,83.0,83.0,83.0,1,1,2,0,4
90501,98.0,98.0,98.0,0,1,0,0,1
90503,84.0,80.4,71.0,3,7,5,0,15
90504,84.0,85.42857142857143,84.0,1,2,4,0,7
90511,90.0,90.375,89.0,1,5,2,0,8
90514,87.0,84.18181818181819,79.0,2,3,6,0,11
90520,80.0,82.66666666666667,80.0,2,3,1,0,6
90539,92.0,93.5,92.0,0,3,1,0,4
90568,86.0,81.15384615384616,75.0,2,3,8,0,13
90580,100.0,100.0,100.0,0,0,0,2,2
90581,89.0,88.77777777777777,87.0,2,4,3,0,9
90583,85.0,86.57142857142857,85.0,2,0,5,0,7
90585,92.0,92.0,90.0,0,4,2,0,6
90588,87.5,87.5,85.0,1,5,2,0,8
90593,89.0,89.0,89.0,1,0,1,0,2
90595,92.0,92.0,92.0,0,0,2,0,2
90603,76.0,76.0,68.0,4,2,4,0,10
90604,84.0,83.25,82.0,2,2,4,0,8
90605,97.0,97.0,94.0,0,1,1,2,4
90614,91.0,91.0,91.0,1,1,0,0,2
90622,57.0,57.0,57.0,3,5,3,0,11
90627,,,,0,0,0,1,1
90643,90.0,90.88888888888889,90.0,0,5,4,0,9
90652,81.0,83.8,81.0,1,6,3,0,10
90672,90.0,92.66666666666667,90.0,0,3,2,1,6
90685,91.0,94.0,91.0,1,1,0,1,3
90701,83.0,85.28571428571429,83.0,2,4,1,0,7
90705,97.0,97.5,96.0,0,3,0,1,4
90709,90.0,89.5,88.0,1,2,5,0,8
90710,85.0,85.5,82.0,3,6,3,0,12
90711,96.0,94.0,89.0,1,2,1,1,5
90733,92.0,91.71428571428571,90.0,0,3,4,0,7
90758,96.0,96.33333333333333,94.0,0,4,1,1,6
90760,100.0,99.33333333333333,98.0,0,1,0,2,3
90772,94.0,94.0,92.0,0,3,3,0,6
90800,96.0,97.0,96.0,0,2,1,1,4
90801,90.0,89.63636363636364,86.0,0,6,5,0,11
90808,96.5,96.5,93.0,1,0,0,1,2
90810,94.0,94.0,94.0,0,1,1,0,2
90813,86.0,84.16666666666667,78.0,2,5,5,0,12
90817,100.0,100.0,100.0,0,0,0,1,1
90818,100.0,100.0,100.0,0,0,0,1,1
90819,89.0,89.0,89.0,1,0,1,0,2
90826,98.0,98.0,98.0,0,1,0,0,1
90833,100.0,100.0,100.0,0,0,0,1,1
90837,94.0,94.57142857142857,94.0,0,6,1,0,7
90839,96.0,96.0,96.0,0,0,1,0,1
90840,90.5,90.5,89.0,1,0,3,0,4
90846,79.0,79.0,79.0,1,1,3,0,5
90862,84.0,84.0,83.0,2,3,3,0,8
90873,98.0,98.0,98.0,0,1,0,0,1
90878,92.0,92.0,92.0,0,2,1,0,3
90886,100.0,100.0,100.0,0,0,0,1,1
90891,98.0,98.0,98.0,0,1,0,0,1
90892,100.0,100.0,100.0,0,0,0,1,1
90893,92.0,92.0,92.0,0,2,3,0,5
90894,90.0,90.0,90.0,0,1,2,0,3
90895,88.0,89.125,87.0,1,2,5,0,8
90930,96.0,96.0,94.0,0,5,0,1,6
90931,100.0,100.0,100.0,0,0,0,2,2
90939,85.0,83.18181818181819,80.0,4,3,4,0,11
90941,83.0,82.06666666666666,79.0,3,8,4,0,15
90950,81.0,81.0,81.0,2,2,5,0,9
90955,86.0,85.55555555555556,85.0,1,5,3,0,9
90971,94.0,93.42857142857143,89.0,1,3,3,0,7
90973,100.0,100.0,100.0,0,0,0,1,1
90974,93.0,93.0,92.0,0,1,3,1,5
90976,92.0,92.25,90.0,0,5,3,0,8
90977,96.0,96.0,92.0,0,2,1,3,6
90989,100.0,99.5,98.0,0,1,0,3,4
90990,100.0,100.0,100.0,0,0,0,4,4
90991,96.0,95.2,92.0,0,0,4,1,5
91012,100.0,100.0,100.0,0,0,0,1,1
91015,94.0,94.4,93.0,2,2,1,0,5
91017,100.0,100.0,100.0,0,0,0,1,1
91019,89.0,87.85714285714286,79.0,4,0,1,2,7
91028,89.0,87.55555555555556,85.0,2,3,4,0,9
91035,82.0,78.9375,73.0,4,7,5,0,16
91038,92.0,92.0,92.0,0,2,1,0,3
91041,81.0,78.66666666666667,72.0,3,5,7,0,15
91042,97.0,97.0,96.0,0,1,1,0,2
91044,79.0,81.27272727272727,79.0,1,5,5,0,11
91067,86.0,82.15384615384616,75.0,1,5,7,0,13
91073,98.0,98.0,96.0,0,0,1,1,2
91074,100.0,99.33333333333333,98.0,0,1,0,2,3
91075,100.0,99.5,98.0,0,1,0,3,4
91078,99.0,99.0,98.0,0,1,0,1,2
91121,94.0,94.5,94.0,0,3,1,0,4
91133,98.0,97.33333333333333,96.0,0,2,1,0,3
91134,96.0,97.33333333333333,96.0,0,1,1,1,3
91152,92.0,92.0,92.0,0,0,2,0,2
91153,87.0,86.63636363636364,85.0,2,5,4,0,11
91157,89.0,89.0,89.0,1,0,1,0,2
91166,89.5,89.5,87.0,1,3,2,0,6
91189,92.0,94.4,92.0,0,4,1,0,5
91191,95.5,95.5,93.0,1,1,0,0,2
91195,100.0,100.0,100.0,0,0,0,2,2
91199,96.0,96.0,96.0,0,2,1,0,3
91205,81.0,83.85714285714286,81.0,2,3,2,0,7
91208,86.0,89.0,86.0,0,6,2,0,8
91209,90.5,90.5,87.0,1,4,1,0,6
91210,92.0,92.0,92.0,0,0,2,0,2
91232,92.0,92.0,92.0,0,0,4,0,4
91236,98.0,98.66666666666667,98.0,0,2,0,1,3
91241,87.5,87.5,86.0,3,0,1,0,4
91245,90.5,90.5,89.0,1,0,3,0,4
91247,100.0,100.0,100.0,0,0,0,1,1
91250,87.0,86.57142857142857,84.0,4,2,1,0,7
91253,78.5,78.5,75.0,1,8,5,0,14
91276,92.0,93.33333333333333,92.0,0,0,3,0,3
91279,94.0,95.0,94.0,0,4,0,0,4
91282,100.0,100.0,100.0,0,0,0,1,1
91287,89.0,89.0,88.0,0,1,5,0,6
91289,90.0,90.55555555555556,89.0,1,6,2,0,9
91298,78.0,80.84615384615384,78.0,1,5,6,1,13
91300,65.0,77.46666666666667,65.0,3,9,3,0,15
91301,98.0,98.0,96.0,0,0,1,1,2
91330,83.0,83.0,83.0,1,1,2,0,4
91331,86.0,88.0,86.0,0,1,5,0,6
91390,80.0,78.625,74.0,4,7,5,0,16
91413,90.0,90.0,90.0,0,1,2,0,3
91427,77.0,78.81818181818181,77.0,2,4,5,0,11
91428,86.0,87.28571428571429,86.0,1,3,3,0,7
91448,82.0,85.72727272727273,81.0,3,4,3,1,11
91450,94.0,94.5,94.0,0,3,1,0,4
91451,74.0,74.0,74.0,2,2,2,0,6
91453,92.0,90.8,89.0,1,2,2,0,5
91457,88.0,88.85714285714286,88.0,0,3,4,0,7
91459,82.0,82.0625,77.0,1,10,5,0,16
91465,71.0,76.75,71.0,3,3,2,0,8
91473,83.0,82.55555555555556,82.0,3,5,1,0,9
91483,92.0,92.22222222222223,90.0,0,7,2,0,9
91486,95.0,95.5,94.0,0,2,2,0,4
91502,96.0,96.0,96.0,0,0,1,0,1
91503,87.0,90.25,87.0,1,1,1,1,4
91525,100.0,100.0,100.0,0,0,0,2,2
91531,86.0,86.0,86.0,0,3,2,0,5
91555,92.0,92.0,92.0,0,2,1,0,3
91561,75.0,75.0,73.0,4,5,3,0,12
91564,96.0,96.0,92.0,0,0,3,2,5
91565,98.0,98.0,98.0,0,1,0,0,1
91571,90.0,90.0,90.0,0,1,2,0,3
91572,82.0,82.0,76.0,4,3,4,0,11
91577,87.0,90.25,87.0,1,1,1,1,4
91587,79.0,79.0,79.0,1,1,3,0,5
91619,72.0,75.38461538461539,72.0,1,5,7,0,13
91620,92.0,93.6,92.0,0,4,1,0,5
91639,90.0,92.0,90.0,0,3,1,1,5
91715,100.0,98.25,93.0,1,0,0,3,4
91717,94.0,94.0,94.0,0,2,2,0,4
91754,98.0,98.0,96.0,0,0,1,1,2
91760,92.0,92.8,92.0,0,3,2,0,5
91762,77.0,82.0,77.0,1,6,4,0,11
91767,94.0,94.66666666666667,94.0,0,1,2,0,3
91802,96.0,96.0,96.0,0,4,0,0,4
91807,84.0,88.8,84.0,2,3,0,0,5
91809,87.0,87.0,87.0,1,1,1,0,3
91811,96.5,96.5,93.0,1,0,0,1,2
91823,92.0,93.33333333333333,92.0,0,2,3,1,6
91828,78.0,76.0,72.0,5,8,5,0,18
91829,100.0,98.66666666666667,96.0,0,0,1,2,3
91830,84.0,86.0,84.0,0,5,2,0,7
91832,94.0,94.0,94.0,0,1,1,0,2
91843,55.0,60.111111111111114,55.0,3,7,8,0,18
91847,86.0,86.0,84.0,2,1,3,0,6
91849,90.0,84.18181818181819,76.0,2,4,5,0,11
91852,89.0,90.5,89.0,2,4,0,0,6
91853,90.0,90.0,87.0,2,4,4,0,10
91873,96.0,96.0,96.0,0,2,0,0,2
91874,86.0,86.0,86.0,0,3,2,0,5
91876,96.0,96.0,96.0,0,2,0,0,2
91907,94.0,94.66666666666667,94.0,0,1,2,0,3
91911,79.0,78.46666666666667,77.0,5,5,5,0,15
91931,85.0,85.0,85.0,1,0,2,0,3
91934,86.0,84.8,80.0,0,10,5,0,15
91954,81.0,80.55555555555556,80.0,3,3,3,0,9
91974,93.5,93.5,91.0,1,3,0,0,4
91977,98.0,98.0,98.0,0,2,0,0,2
91979,94.0,95.33333333333333,94.0,0,2,1,0,3
91986,97.0,97.0,96.0,0,1,1,0,2
91989,94.0,94.66666666666667,92.0,0,1,4,1,6
91999,90.0,90.44444444444444,90.0,0,4,5,0,9
92022,94.0,93.14285714285714,90.0,0,3,4,0,7
92029,90.0,89.77777777777777,88.0,0,5,4,0,9
92042,98.0,98.0,96.0,0,0,1,1,2
92044,83.0,83.0,83.0,1,1,2,0,4
92049,86.0,84.22222222222223,82.0,2,5,2,0,9
92050,100.0,100.0,100.0,0,0,0,1,1
92066,96.0,96.0,96.0,0,0,1,0,1
92068,99.0,99.0,98.0,0,1,0,1,2
92075,92.5,93.25,92.0,1,0,3,0,4
92095,94.0,94.4,92.0,0,1,3,1,5
92099,78.0,79.64285714285714,73.0,7,4,3,0,14
92102,100.0,100.0,100.0,0,0,0,1,1
92110,98.0,98.0,96.0,0,0,1,1,2
92116,67.0,76.0909090909091,67.0,3,6,2,0,11
92119,96.0,96.0,96.0,0,2,0,0,2
92141,85.0,85.0,85.0,1,2,1,0,4
92149,85.0,88.0,85.0,1,2,1,1,5
92151,100.0,99.33333333333333,98.0,0,1,0,2,3
92171,93.0,93.0,92.0,0,1,3,0,4
92173,92.0,94.0,92.0,0,2,1,1,4
92174,90.0,92.0,90.0,0,3,1,1,5
92187,90.0,89.2,88.0,0,4,6,0,10
92199,96.0,96.0,96.0,0,0,2,0,2
92242,90.0,90.0,90.0,0,3,1,0,4
92252,100.0,100.0,100.0,0,0,0,2,2
92253,100.0,100.0,100.0,0,0,0,1,1
92268,96.0,96.0,96.0,0,0,1,0,1
92283,77.0,81.4,77.0,1,4,5,0,10
92287,86.0,87.16666666666667,86.0,1,3,2,0,6
92288,89.0,92.66666666666667,89.0,1,0,1,1,3
92301,100.0,100.0,100.0,0,0,0,2,2
92306,100.0,100.0,100.0,0,0,0,1,1
92313,96.0,96.0,96.0,0,6,0,0,6
92338,96.0,96.0,96.0,0,0,2,0,2
92339,92.0,92.0,92.0,0,2,1,0,3
92352,79.0,78.11111111111111,77.0,4,2,3,0,9
92382,87.0,87.0,85.0,2,2,2,0,6
92383,88.0,89.2,88.0,1,1,3,0,5
92384,100.0,100.0,100.0,0,0,0,1,1
92387,90.0,93.11111111111111,90.0,0,8,0,1,9
92393,91.0,90.88888888888889,90.0,1,6,2,0,9
92409,98.0,98.0,98.0,0,1,0,0,1
92428,100.0,100.0,100.0,0,0,0,1,1
92438,74.0,76.4,72.0,4,4,7,0,15
92441,83.0,84.5,82.0,3,2,3,0,8
92444,94.5,94.5,93.0,1,0,1,0,2
92449,92.0,92.8,92.0,0,3,2,0,5
92453,73.0,77.95652173913044,73.0,3,9,11,0,23
92455,94.0,93.33333333333333,92.0,0,2,4,0,6
92459,75.0,78.33333333333333,75.0,2,7,3,0,12
92467,90.0,90.0,90.0,0,3,1,0,4
92475,95.0,96.0,94.0,0,1,2,1,4
92477,94.0,94.0,94.0,0,1,1,0,2
92509,98.0,98.0,98.0,0,1,0,0,1
92530,81.0,81.0,81.0,2,0,6,0,8
92537,81.0,83.8,81.0,1,4,4,1,10
92540,78.0,79.0,72.0,4,2,6,0,12
92555,92.0,91.125,87.0,1,5,2,0,8
92568,80.0,77.66666666666667,75.0,1,9,5,0,15
92584,85.0,86.5,85.0,2,3,5,0,10
92592,66.0,73.875,66.0,4,8,4,0,16
92598,100.0,100.0,100.0,0,0,0,1,1
92611,90.0,88.54545454545455,86.0,0,6,5,0,11
92642,92.0,92.0,92.0,0,2,1,0,3
92648,100.0,100.0,100.0,0,0,0,1,1
92659,92.0,92.0,92.0,0,0,2,0,2
92665,92.0,92.0,92.0,0,0,2,0,2
92666,81.0,84.71428571428571,81.0,1,3,3,0,7
92670,100.0,100.0,100.0,0,0,0,1,1
92707,94.0,94.0,92.0,0,4,2,0,6
92764,100.0,100.0,100.0,0,0,0,2,2
92766,88.0,88.66666666666667,87.0,2,1,1,2,6
92767,93.0,93.66666666666667,90.0,0,3,2,1,6
92785,98.0,98.0,98.0,0,1,0,0,1
92812,86.0,86.0,86.0,0,1,3,0,4
92814,93.0,93.0,92.0,0,1,3,0,4
92825,75.0,75.0,75.0,1,3,3,0,7
92844,67.0,73.9,67.0,3,3,4,0,10
92894,100.0,100.0,100.0,0,0,0,2,2
92906,89.0,89.0,89.0,1,2,0,0,3
92907,100.0,100.0,100.0,0,0,0,3,3
92917,100.0,100.0,100.0,0,0,0,1,1
92927,93.0,93.0,93.0,1,0,0,0,1
92928,75.0,78.5,75.0,2,1,5,0,8
92935,100.0,100.0,100.0,0,0,0,1,1
92939,88.0,87.4,85.0,2,4,4,0,10
92980,93.0,93.0,93.0,1,0,0,0,1
92982,92.0,89.77777777777777,86.0,0,4,5,0,9
92983,72.0,77.53846153846153,72.0,2,7,4,0,13
92993,74.0,75.76,72.0,4,8,13,0,25
92995,92.0,92.33333333333333,92.0,1,0,2,0,3
92996,100.0,100.0,100.0,0,0,0,2,2
92998,92.0,93.6,92.0,0,4,1,0,5
93022,94.0,95.0,92.0,0,0,3,1,4
93023,92.0,93.33333333333333,92.0,0,0,3,0,3
93036,90.0,92.4,90.0,0,3,2,0,5
93060,94.0,94.0,94.0,0,1,1,0,2
93063,98.0,98.0,98.0,0,1,0,0,1
93064,83.0,86.4,83.0,1,1,2,1,5
93065,71.0,76.0,71.0,1,5,7,0,13
93072,88.0,88.0,88.0,0,6,3,0,9
93073,90.0,91.6,90.0,0,2,3,0,5
93080,90.0,92.4,90.0,0,3,2,0,5
93105,96.0,96.0,96.0,0,2,0,0,2
93127,83.0,86.4,83.0,1,1,2,1,5
93150,64.0,64.0,64.0,4,0,2,0,6
93182,84.0,82.4,78.0,0,6,9,0,15
93187,88.0,88.3,87.0,1,4,5,0,10
93189,86.0,87.23076923076923,86.0,0,7,6,0,13
93193,99.0,99.0,98.0,0,1,0,1,2
93197,89.5,89.5,87.0,1,3,2,0,6
93223,85.0,85.0,85.0,1,2,1,0,4
93240,95.0,95.0,94.0,0,3,1,0,4
93243,87.0,87.0,87.0,1,1,1,0,3
93245,85.0,85.0,85.0,1,2,1,0,4
93250,88.0,88.85714285714286,88.0,0,3,4,0,7
93268,96.0,96.0,96.0,0,0,1,0,1
93281,100.0,99.5,98.0,0,2,1,1,4
93289,81.0,80.76470588235294,79.0,3,10,4,0,17
93297,100.0,100.0,100.0,0,0,0,1,1
93305,96.0,96.66666666666667,96.0,0,3,0,0,3
93306,96.0,96.0,96.0,0,2,1,0,3
93309,86.0,88.0,86.0,0,1,5,0,6
93314,100.0,100.0,100.0,0,0,0,1,1
93336,88.0,88.0,88.0,0,4,1,0,5
93361,88.0,89.0,88.0,1,3,2,0,6
93362,72.0,72.0,72.0,2,3,2,0,7
93390,87.0,87.0,87.0,1,1,1,0,3
93401,85.0,86.875,85.0,1,5,2,0,8
93422,85.0,86.6,85.0,2,2,1,0,5
93424,94.0,95.33333333333333,94.0,0,2,1,0,3
93428,88.0,88.42857142857143,88.0,1,4,2,0,7
93431,87.0,87.0,87.0,1,1,1,0,3
93453,96.0,96.0,96.0,0,2,0,0,2
93460,96.0,96.0,96.0,0,0,1,0,1
93469,92.0,92.0,90.0,0,4,2,0,6
93473,97.0,97.0,96.0,0,1,1,0,2
93484,89.0,89.0,89.0,1,0,1,0,2
93488,100.0,100.0,100.0,0,0,0,1,1
93492,98.0,98.0,96.0,0,1,1,1,3
93496,89.0,89.0,88.0,0,1,5,0,6
93501,100.0,100.0,100.0,0,0,0,1,1
93502,64.0,64.0,64.0,2,1,5,0,8
93533,83.0,84.5,80.0,4,1,3,0,8
93536,95.0,95.0,94.0,0,3,1,0,4
93539,85.0,85.0,85.0,1,2,1,0,4
93546,100.0,100.0,100.0,0,0,0,1,1
93549,81.0,82.77777777777777,81.0,2,4,3,0,9
93559,90.0,91.6,90.0,0,2,3,0,5
93561,88.0,89.33333333333333,88.0,0,2,4,0,6
93572,92.0,93.33333333333333,92.0,0,0,3,0,3
93573,80.0,84.28571428571429,80.0,2,2,3,0,7
93607,88.0,88.0,88.0,0,2,2,0,4
93615,94.0,93.66666666666667,89.0,1,1,3,1,6
93617,81.0,83.0,81.0,2,5,2,0,9
93619,90.0,90.0,90.0,0,1,2,0,3
93623,94.0,94.66666666666667,94.0,0,1,2,0,3
93636,87.0,90.6,87.0,1,3,1,0,5
93647,98.0,96.33333333333333,93.0,1,1,0,1,3
93777,94.0,94.0,94.0,0,1,1,0,2
93815,91.0,92.66666666666667,91.0,1,1,1,0,3
93822,96.0,96.0,96.0,0,0,1,0,1
93835,82.0,84.0,82.0,2,9,4,0,15
93855,96.0,96.66666666666667,96.0,0,3,0,0,3
93897,92.0,92.0,92.0,0,2,1,0,3
93900,81.5,81.5,80.0,3,2,3,0,8
93911,92.0,93.0,92.0,0,3,3,0,6
93912,94.0,94.0,94.0,0,1,1,0,2
93913,78.0,84.0,78.0,2,2,3,0,7
93936,88.0,88.3076923076923,86.0,0,11,2,0,13
93946,90.0,90.0,90.0,0,1,2,0,3
93947,92.0,91.66666666666667,89.0,1,2,3,0,6
93951,87.5,87.5,86.0,3,0,1,0,4
93955,97.0,97.5,96.0,0,1,2,1,4
93957,100.0,100.0,100.0,0,0,0,4,4
93959,100.0,99.6,98.0,0,1,0,4,5
93968,96.0,96.66666666666667,96.0,0,1,2,0,3
93969,98.0,97.0,93.0,1,3,0,1,5
93973,82.0,83.125,82.0,1,1,6,0,8
93977,94.0,92.85714285714286,90.0,0,2,5,0,7
93989,88.0,88.0,88.0,0,2,2,0,4
93993,86.0,86.0,86.0,0,3,2,0,5
94013,74.0,78.33333333333333,74.0,2,0,3,1,6
94037,74.0,77.14285714285714,74.0,2,2,3,0,7
94061,88.0,90.66666666666667,88.0,0,4,2,0,6
94082,92.0,92.8,92.0,0,3,2,0,5
94094,82.0,83.45454545454545,82.0,0,6,5,0,11
94103,86.0,86.0,86.0,0,1,3,0,4
94126,94.0,96.0,94.0,0,1,1,1,3
94127,94.0,94.0,94.0,0,1,1,0,2
94142,100.0,100.0,100.0,0,0,0,2,2
94149,98.0,98.0,96.0,0,0,1,1,2
94175,86.0,86.0,86.0,0,1,3,0,4
94182,83.5,83.5,82.0,3,4,1,0,8
94185,100.0,100.0,100.0,0,0,0,1,1
94187,85.5,85.5,83.0,1,3,4,0,8
94189,97.0,97.0,96.0,0,1,1,0,2
94190,94.0,94.66666666666667,94.0,0,1,2,0,3
94209,96.0,96.0,96.0,0,0,1,0,1
94229,84.0,84.0,84.0,0,6,1,0,7
94231,85.0,85.0,85.0,1,2,1,0,4
94235,84.5,84.5,79.0,3,1,2,0,6
94255,93.0,95.33333333333333,93.0,2,0,0,1,3
94269,65.0,69.5,65.0,1,4,7,0,12
94280,100.0,100.0,100.0,0,0,0,1,1
94305,90.0,90.0,90.0,0,3,1,0,4
94310,100.0,100.0,100.0,0,0,0,1,1
94318,88.0,88.0,88.0,0,2,2,0,4
94337,94.0,96.0,94.0,0,1,1,1,3
94347,82.0,83.46153846153847,81.0,1,4,8,0,13
94351,58.0,58.0,58.0,4,3,2,0,9
94352,98.0,98.0,98.0,0,1,0,0,1
94354,89.0,89.0,89.0,1,2,0,0,3
94355,85.0,85.0,85.0,1,0,2,0,3
94388,86.0,86.0,85.0,2,1,3,0,6
94394,85.5,85.5,84.0,3,2,1,0,6
94408,80.0,77.29411764705883,70.0,2,5,10,0,17
94412,99.0,99.0,98.0,0,1,0,1,2
94432,100.0,100.0,100.0,0,0,0,2,2
94442,81.0,81.0,81.0,1,0,3,0,4
94455,85.0,88.6,85.0,1,1,3,0,5
94460,94.0,94.0,94.0,0,1,1,0,2
94465,81.0,81.0,81.0,2,4,4,0,10
94502,86.0,87.42857142857143,86.0,1,4,2,0,7
94521,86.0,88.28571428571429,86.0,0,4,3,0,7
94522,96.0,96.0,96.0,0,0,1,0,1
94540,96.0,97.33333333333333,96.0,0,2,0,1,3
94542,80.0,85.53846153846153,80.0,0,8,5,0,13
94543,96.0,96.0,96.0,0,0,1,0,1
94547,96.0,96.0,96.0,0,2,0,0,2
94555,92.0,93.33333333333333,92.0,0,0,3,0,3
94574,100.0,100.0,100.0,0,0,0,1,1
94578,98.0,98.0,96.0,0,0,1,1,2
94592,98.0,98.0,98.0,0,1,0,0,1
94600,84.0,88.22222222222223,84.0,0,5,4,0,9
94604,90.0,90.75,90.0,1,1,2,0,4
94605,92.0,91.6,91.0,1,3,1,0,5
94609,94.0,94.0,94.0,0,3,0,0,3
94612,86.0,88.0,86.0,0,1,4,0,5
94614,80.0,80.0,80.0,4,2,2,0,8
94615,88.0,88.0,88.0,0,4,1,0,5
94616,90.0,92.4,90.0,0,3,2,0,5
94631,90.0,90.0,90.0,0,1,2,0,3
94646,89.0,89.0,89.0,1,0,1,0,2
94658,100.0,100.0,100.0,0,0,0,3,3
94660,100.0,99.33333333333333,98.0,0,1,0,2,3
94695,84.0,86.66666666666667,84.0,0,6,3,0,9
94701,94.0,96.0,94.0,0,1,1,1,3
94702,88.0,89.33333333333333,88.0,0,2,4,0,6
94703,90.0,89.6,89.0,1,1,3,0,5
94710,70.0,69.38888888888889,62.0,7,5,6,0,18
94722,88.0,88.0,88.0,0,2,2,0,4
94726,89.5,89.5,87.0,1,3,2,0,6
94739,90.0,90.85714285714286,90.0,0,3,3,1,7
94790,87.0,90.25,87.0,1,1,1,1,4
94792,98.0,98.0,96.0,0,0,1,1,2
94802,96.0,96.0,96.0,0,0,1,0,1
94806,98.0,98.0,98.0,0,1,0,0,1
94815,94.0,94.0,94.0,0,1,1,0,2
94828,87.0,89.25,87.0,1,1,2,0,4
94837,98.0,98.0,98.0,0,1,0,0,1
94843,92.0,92.0,92.0,0,4,2,0,6
94848,88.0,88.0,87.0,2,3,1,0,6
94868,96.0,96.0,96.0,0,0,1,0,1
94890,87.0,87.0,87.0,1,3,0,0,4
94894,83.0,83.6,82.0,1,7,7,0,15
94903,92.0,94.66666666666667,92.0,0,0,2,1,3
94910,77.0,77.0,77.0,1,4,2,0,7
94921,86.0,86.0,86.0,0,1,3,0,4
94922,83.0,83.0,83.0,1,3,1,0,5
94928,71.0,78.6,71.0,3,5,2,0,10
94929,90.0,90.0,90.0,0,3,1,0,4
94952,94.0,94.0,94.0,0,1,1,0,2
94954,80.0,77.6923076923077,75.0,1,5,7,0,13
94959,82.0,82.36363636363636,80.0,5,3,3,0,11
94995,98.0,98.0,96.0,0,1,1,1,3
95014,85.0,87.0,85.0,2,3,1,0,6
95016,92.0,92.0,92.0,0,2,1,0,3
95018,96.0,96.0,96.0,0,0,1,0,1
95019,89.0,89.0,89.0,1,0,1,0,2
95021,87.0,88.66666666666667,87.0,1,3,2,0,6
95022,92.0,92.0,92.0,0,0,2,0,2
95023,92.0,93.0,92.0,0,2,2,0,4
95032,100.0,100.0,100.0,0,0,0,1,1
95033,96.0,96.0,96.0,0,2,0,0,2
95065,81.0,81.0,81.0,1,2,2,0,5
95095,92.0,92.33333333333333,92.0,1,0,2,0,3
95114,89.0,87.22222222222223,84.0,2,3,4,0,9
95130,94.0,94.0,94.0,0,1,1,0,2
95162,92.0,93.6,92.0,0,4,1,0,5
95169,90.0,90.0,90.0,0,1,2,0,3
95174,94.0,94.0,94.0,0,1,1,0,2
95177,85.0,85.0,85.0,1,0,2,0,3
95180,86.0,88.66666666666667,86.0,0,2,4,0,6
95184,94.0,94.0,94.0,0,1,1,0,2
95188,88.0,89.71428571428571,88.0,0,5,2,0,7
95192,98.0,98.0,98.0,0,1,0,0,1
95361,77.0,77.9090909090909,77.0,2,3,6,0,11
95363,94.0,94.0,94.0,0,1,1,0,2
95366,80.0,83.07692307692308,80.0,0,10,3,0,13
95375,89.0,89.875,88.0,1,3,4,0,8
95377,92.0,94.0,92.0,0,1,2,0,3
95400,80.0,80.0,78.0,4,2,2,0,8
95401,89.0,89.0,89.0,1,2,0,0,3
95410,98.0,98.0,98.0,0,1,0,0,1
95440,82.0,82.0,82.0,2,0,1,0,3
95441,90.0,90.0,90.0,0,1,2,0,3
95452,98.0,98.0,98.0,0,1,0,0,1
95455,90.0,91.5,90.0,0,1,3,0,4
95463,86.0,87.71428571428571,86.0,0,6,1,0,7
95468,95.0,95.0,94.0,0,3,1,0,4
95470,94.0,94.0,94.0,0,1,1,0,2
95481,96.0,96.0,96.0,0,0,1,0,1
95495,86.0,86.75,86.0,0,3,5,0,8
95537,90.0,90.0,90.0,0,6,2,0,8
95539,82.0,85.33333333333333,82.0,2,2,2,0,6
95554,96.0,96.0,96.0,0,0,1,0,1
95556,90.0,91.2,90.0,0,3,2,0,5
95558,100.0,100.0,100.0,0,0,0,1,1
95560,92.0,92.0,92.0,0,0,2,0,2
95569,90.0,88.22222222222223,86.0,0,6,3,0,9
95584,96.0,96.0,96.0,0,2,0,0,2
95590,92.0,92.0,92.0,0,0,2,0,2
95592,80.0,80.0,80.0,2,1,1,0,4
95621,100.0,100.0,100.0,0,0,0,2,2
95643,100.0,100.0,100.0,0,0,0,1,1
95656,89.5,89.5,89.0,1,3,2,0,6
95657,98.0,98.0,96.0,0,0,1,1,2
95671,81.0,81.0,81.0,1,2,2,0,5
95676,82.0,85.5,82.0,0,5,3,0,8
95681,94.0,95.33333333333333,94.0,0,2,1,0,3
95684,92.0,92.0,92.0,0,0,2,0,2
95702,98.0,98.0,98.0,0,1,0,0,1
95733,100.0,100.0,100.0,0,0,0,1,1
95750,84.0,84.0,84.0,0,2,3,0,5
95754,84.0,84.0,84.0,0,2,3,0,5
95761,91.0,90.625,87.0,2,5,1,0,8
95764,92.0,94.66666666666667,92.0,0,0,2,1,3
95768,87.0,87.0,87.0,1,1,1,0,3
95845,85.0,85.0,85.0,1,0,2,0,3
95897,100.0,100.0,100.0,0,0,0,1,1
95899,100.0,100.0,100.0,0,0,0,1,1
95902,94.0,96.0,94.0,0,1,1,1,3
95903,96.0,96.0,96.0,0,0,1,0,1
95922,100.0,100.0,100.0,0,0,0,1,1
95961,100.0,100.0,100.0,0,0,0,1,1
96024,100.0,100.0,100.0,0,0,0,1,1
96027,92.0,92.0,92.0,0,4,0,0,4
96034,98.0,98.0,98.0,0,1,0,0,1
96063,81.0,81.0,81.0,1,2,2,0,5
96110,85.0,85.0,85.0,1,2,1,0,4
96198,71.0,71.0,71.0,3,0,2,0,5
96202,85.0,87.8,85.0,1,0,4,0,5
96214,87.0,90.25,87.0,1,1,1,1,4
96237,100.0,100.0,100.0,0,0,0,1,1
96268,94.0,94.0,94.0,0,1,1,0,2
96280,89.0,89.0,89.0,1,0,1,0,2
96285,83.5,83.5,81.0,1,1,6,0,8
96292,90.0,90.0,90.0,0,1,2,0,3
96300,96.0,96.0,96.0,0,2,0,0,2
96318,78.0,82.28571428571429,78.0,2,0,5,0,7
96369,93.0,93.0,93.0,1,0,0,0,1
96433,100.0,100.0,100.0,0,0,0,1,1
96451,85.0,85.0,85.0,1,0,2,0,3
96529,81.0,83.57142857142857,81.0,2,1,4,0,7
96530,100.0,100.0,100.0,0,0,0,1,1
96532,92.0,92.0,92.0,0,2,1,0,3
96533,100.0,100.0,100.0,0,0,0,1,1
96534,100.0,100.0,100.0,0,0,0,1,1
96536,80.0,80.0,80.0,2,3,0,0,5
96537,92.0,93.6,92.0,0,4,1,0,5
96564,100.0,100.0,100.0,0,0,0,1,1
96565,80.0,80.0,80.0,2,3,0,0,5
96567,98.0,98.0,98.0,0,1,0,0,1
96569,85.0,85.0,85.0,1,2,1,0,4
96571,82.5,82.5,78.0,3,3,2,0,8
96573,90.0,91.5,90.0,0,1,3,0,4
96575,96.0,96.0,96.0,0,0,1,0,1
96577,92.0,92.0,92.0,0,2,1,0,3
96578,78.0,78.0,78.0,0,3,4,0,7
96583,96.0,96.0,96.0,0,2,0,0,2
96584,82.0,82.0,82.0,0,5,2,0,7
96589,85.0,85.0,85.0,1,0,2,0,3
96591,82.0,83.45454545454545,80.0,4,3,4,0,11
96592,89.0,89.0,89.0,1,0,1,0,2
96598,98.0,98.0,98.0,0,1,0,0,1
96599,94.0,94.66666666666667,94.0,0,1,2,0,3
96600,92.0,92.0,92.0,0,2,1,0,3
96608,100.0,100.0,100.0,0,0,0,1,1
96632,83.0,83.0,83.0,1,1,2,0,4
96634,88.0,88.0,88.0,0,0,3,0,3
96645,82.0,82.0,82.0,2,0,1,0,3
96653,90.0,90.4,90.0,1,2,2,0,5
96654,83.0,83.0,83.0,1,3,1,0,5
96670,100.0,100.0,100.0,0,0,0,1,1
96671,94.0,94.0,94.0,0,1,1,0,2
96692,93.0,93.0,93.0,1,0,0,0,1
96721,92.0,92.0,92.0,0,2,1,0,3
96745,98.0,98.0,98.0,0,1,0,0,1
96772,100.0,100.0,100.0,0,0,0,1,1
96775,94.0,94.0,94.0,0,4,1,0,5
96794,,,,1,1,0,0,2
96813,64.0,71.28571428571429,64.0,5,8,1,0,14
96824,92.0,92.0,92.0,0,0,2,0,2
96845,90.0,91.2,90.0,0,3,2,0,5
96864,91.0,91.0,91.0,1,1,0,0,2
96909,98.0,98.0,96.0,0,0,1,1,2
96913,94.0,94.5,94.0,0,3,1,0,4
96916,98.0,98.0,98.0,0,1,0,0,1
97048,90.0,90.66666666666667,90.0,0,3,3,0,6
97065,93.0,93.0,93.0,1,0,0,0,1
97078,92.0,92.0,92.0,0,0,2,0,2
97102,72.0,76.54545454545455,72.0,2,2,7,0,11
97104,86.0,87.71428571428571,86.0,0,2,5,0,7
97106,94.0,94.0,94.0,0,1,1,0,2
97156,100.0,100.0,100.0,0,0,0,2,2
97189,92.0,92.0,92.0,0,2,3,0,5
97190,93.0,93.0,93.0,1,0,0,0,1
97200,86.0,86.0,86.0,0,1,3,0,4
97218,89.0,89.0,89.0,1,0,1,0,2
97219,85.5,85.5,83.0,1,3,4,0,8
97237,92.0,92.0,92.0,0,2,1,0,3
97259,80.0,80.0,80.0,0,2,4,0,6
97261,88.0,88.0,88.0,0,0,3,0,3
97277,85.0,85.0,85.0,2,4,2,0,8
97282,96.0,96.0,96.0,0,2,0,0,2
97283,84.0,84.0,84.0,0,0,4,0,4
97295,83.0,86.0,83.0,1,2,4,0,7
97296,87.0,89.8,87.0,1,2,2,0,5
97321,93.0,93.0,92.0,0,1,3,0,4
97356,70.0,76.0,70.0,2,6,4,0,12
97358,96.0,96.0,96.0,0,0,1,0,1
97372,98.0,98.0,98.0,0,1,0,0,1
97398,96.0,96.0,96.0,0,2,0,0,2
97411,100.0,100.0,100.0,0,0,0,1,1
97412,96.0,96.0,96.0,0,0,1,0,1
97431,100.0,100.0,100.0,0,0,0,1,1
97432,84.0,84.0,84.0,0,2,3,0,5
97468,96.0,96.0,96.0,0,2,0,0,2
97469,84.0,84.0,84.0,2,1,0,0,3
97482,100.0,100.0,100.0,0,0,0,1,1
97496,98.0,98.0,98.0,0,1,0,0,1
97503,92.0,92.0,92.0,0,2,1,0,3
97518,93.0,93.0,93.0,1,0,0,0,1
97519,78.0,82.66666666666667,78.0,0,3,6,0,9
97536,100.0,100.0,100.0,0,0,0,2,2
97549,90.0,90.0,90.0,0,4,3,0,7
97550,94.0,94.66666666666667,94.0,0,1,2,0,3
97613,85.0,85.0,85.0,1,0,2,0,3
97661,90.0,90.0,90.0,0,1,2,0,3
97662,96.0,96.0,96.0,0,2,0,0,2
97663,96.0,96.0,96.0,0,0,1,0,1
97682,86.0,86.0,86.0,0,1,3,0,4
97683,89.0,89.0,89.0,1,2,0,0,3
97684,94.0,94.0,94.0,0,1,1,0,2
97735,79.0,79.88888888888889,79.0,2,1,6,0,9
97736,90.0,90.0,90.0,0,1,2,0,3
97776,98.0,98.0,98.0,0,1,0,0,1
97795,96.0,96.0,96.0,0,0,1,0,1
97801,94.0,94.0,94.0,0,1,1,0,2
97803,96.0,96.0,96.0,0,0,1,0,1
97804,100.0,100.0,100.0,0,0,0,2,2
97805,92.0,92.0,92.0,0,0,2,0,2
97806,91.5,91.5,91.0,1,1,2,0,4
97829,88.0,88.0,88.0,0,2,2,0,4
97830,100.0,100.0,100.0,0,0,0,1,1
97841,86.0,86.0,86.0,0,3,2,0,5
97877,96.0,96.0,96.0,0,2,0,0,2
97879,88.0,86.71428571428571,85.0,1,2,4,0,7
97882,94.0,94.0,94.0,0,2,2,0,4
97894,93.0,93.0,93.0,1,0,0,0,1
97896,83.0,83.0,83.0,1,1,2,0,4
97928,77.0,77.0,77.0,1,0,4,0,5
97929,98.0,98.0,98.0,0,1,0,0,1
97938,86.0,86.0,86.0,0,1,3,0,4
97940,100.0,100.0,100.0,0,0,0,1,1
97954,98.0,98.0,98.0,0,1,0,0,1
97956,90.0,90.0,90.0,0,3,1,0,4
97973,78.0,81.375,78.0,3,3,2,0,8
97975,96.0,96.0,96.0,0,2,1,0,3
97989,74.0,74.0,73.0,2,5,7,0,14
98013,100.0,100.0,100.0,0,0,0,1,1
98047,98.0,98.0,96.0,0,0,1,1,2
98050,88.0,88.0,88.0,0,0,3,0,3
98063,90.0,90.0,90.0,0,1,2,0,3
98071,91.0,91.0,91.0,1,1,0,0,2
98082,90.0,90.0,90.0,0,1,2,0,3
98113,72.0,72.0,72.0,2,1,3,0,6
98118,84.0,85.0,84.0,1,5,3,0,9
98140,90.0,90.0,90.0,0,1,2,0,3
98154,74.0,74.0,74.0,2,2,2,0,6
98173,96.0,97.33333333333333,96.0,0,2,0,1,3
98174,96.0,96.0,96.0,0,0,1,0,1
98176,96.0,96.0,96.0,0,0,1,0,1
98177,95.0,95.0,94.0,0,3,1,0,4
98184,100.0,100.0,100.0,0,0,0,1,1
98221,98.0,98.0,96.0,0,0,1,1,2
98222,86.0,86.0,86.0,0,1,3,0,4
98223,98.0,98.0,98.0,0,1,0,0,1
98225,100.0,100.0,100.0,0,0,0,1,1
98226,98.0,98.0,98.0,0,1,0,0,1
98229,96.0,96.0,96.0,0,0,1,0,1
98256,98.0,98.0,98.0,0,1,0,0,1
98278,86.0,86.0,86.0,0,2,6,0,8
98280,76.0,79.75,76.0,3,4,1,0,8
98283,98.0,98.0,98.0,0,1,0,0,1
98293,100.0,100.0,100.0,0,0,0,1,1
98301,99.0,99.0,98.0,0,1,0,1,2
98303,82.0,82.0,82.0,2,0,1,0,3
98309,96.0,96.0,96.0,0,0,1,0,1
98329,72.0,79.71428571428571,72.0,4,1,2,0,7
98334,100.0,100.0,100.0,0,0,0,1,1
98360,86.0,86.0,86.0,0,3,2,0,5
98375,84.0,84.0,84.0,2,1,0,0,3
98376,92.0,92.0,92.0,0,0,2,0,2
98378,100.0,100.0,100.0,0,0,0,1,1
98379,86.0,86.0,86.0,0,1,3,0,4
98615,73.0,75.7,73.0,3,2,5,0,10
98616,100.0,100.0,100.0,0,0,0,1,1
98618,88.0,88.0,88.0,0,2,2,0,4
98657,93.0,93.0,93.0,1,0,0,0,1
98673,88.0,88.0,88.0,0,0,3,0,3
98772,86.0,86.0,86.0,2,0,0,0,2
98806,100.0,100.0,100.0,0,0,0,1,1
98823,100.0,100.0,100.0,0,0,0,1,1
98824,96.0,96.0,96.0,0,2,0,0,2
98825,90.0,90.0,90.0,0,3,1,0,4
98847,94.0,94.0,94.0,0,1,1,0,2
98866,81.0,81.0,81.0,1,2,2,0,5
98872,92.0,92.0,92.0,0,2,1,0,3
98890,100.0,100.0,100.0,0,0,0,1,1
98904,86.0,86.0,86.0,0,1,3,0,4
98916,98.0,98.0,98.0,0,1,0,0,1
98971,100.0,100.0,100.0,0,0,0,1,1
98972,88.0,86.8,85.0,1,8,1,0,10
98973,98.0,98.0,98.0,0,1,0,0,1
98974,80.0,83.42857142857143,80.0,2,1,4,0,7
98985,90.0,90.0,90.0,0,1,2,0,3
98995,64.0,64.0,64.0,2,3,4,0,9
99014,,,,0,4,4,0,8
99015,81.0,81.0,81.0,1,2,2,0,5
99016,100.0,100.0,100.0,0,0,0,1,1
99045,88.0,90.66666666666667,88.0,0,4,2,0,6
99046,98.0,98.0,98.0,0,1,0,0,1
99048,96.0,96.0,96.0,0,2,0,0,2
99056,74.0,74.0,74.0,2,0,3,0,5
99059,94.0,94.0,94.0,0,1,1,0,2
99085,83.0,83.0,83.0,1,3,1,0,5
99102,96.0,96.0,96.0,0,0,1,0,1
99134,87.0,87.0,87.0,1,1,1,0,3
99135,94.0,94.0,94.0,0,1,1,0,2
99136,73.0,73.0,73.0,1,2,4,0,7
99182,100.0,100.0,100.0,0,0,0,1,1
99189,94.0,94.0,94.0,0,3,0,0,3
99191,94.0,94.0,94.0,0,1,1,0,2
99192,94.0,94.0,94.0,0,3,0,0,3
99194,96.0,96.0,96.0,0,0,1,0,1
99235,94.0,94.0,94.0,0,1,1,0,2
99249,96.0,96.0,96.0,0,0,1,0,1
99250,100.0,100.0,100.0,0,0,0,1,1
99252,98.0,98.0,98.0,0,1,0,0,1
99253,94.0,94.0,94.0,0,1,1,0,2
99268,85.0,85.0,85.0,1,4,0,0,5
99269,91.0,91.0,91.0,1,1,0,0,2
99272,85.0,85.0,85.0,1,2,1,0,4
99274,94.0,94.0,94.0,0,1,1,0,2
99277,100.0,100.0,100.0,0,0,0,1,1
99295,96.0,96.0,96.0,0,2,0,0,2
99298,84.0,84.0,84.0,0,2,3,0,5
99331,96.0,96.0,96.0,0,0,1,0,1
99341,69.0,69.0,69.0,3,3,1,0,7
99386,86.0,86.0,86.0,2,0,0,0,2
99387,94.0,94.0,94.0,0,1,1,0,2
99388,90.0,90.0,90.0,0,3,1,0,4
99396,96.0,96.0,96.0,0,0,1,0,1
99397,78.0,78.0,78.0,2,0,2,0,4
99419,96.0,97.33333333333333,96.0,0,2,0,1,3
99421,73.0,73.0,73.0,1,4,3,0,8
99432,76.0,76.0,76.0,2,1,2,0,5
99510,100.0,100.0,100.0,0,0,0,1,1
99590,85.0,85.0,85.0,1,2,1,0,4
99679,100.0,100.0,100.0,0,0,0,1,1
99695,96.0,96.0,96.0,0,0,1,0,1
99706,90.0,90.0,90.0,0,1,2,0,3
99707,87.0,87.0,87.0,1,3,0,0,4
99708,93.0,93.0,93.0,1,0,0,0,1
99709,94.0,94.0,94.0,0,1,1,0,2
99717,93.0,93.0,93.0,1,0,0,0,1
99719,90.0,90.0,90.0,0,3,1,0,4
99729,96.0,96.0,96.0,0,0,1,0,1
99733,100.0,100.0,100.0,0,0,0,1,1
99738,92.0,92.0,92.0,0,2,1,0,3
99740,96.0,96.0,96.0,0,0,1,0,1
99747,88.0,88.0,88.0,0,2,2,0,4
99757,83.0,85.83333333333333,83.0,1,3,1,1,6
99761,70.0,70.0,70.0,4,1,0,0,5
99764,74.0,74.0,74.0,2,0,3,0,5
99777,91.0,91.0,91.0,1,1,0,0,2
99778,92.0,92.0,92.0,0,2,1,0,3
99783,98.0,98.0,98.0,0,1,0,0,1
99788,78.0,78.0,78.0,2,2,1,0,5
99794,100.0,100.0,100.0,0,0,0,1,1
99818,100.0,100.0,100.0,0,0,0,1,1
99820,90.0,90.0,90.0,0,1,2,0,3
99991,100.0,100.0,100.0,0,0,0,1,1
100041,83.0,83.0,83.0,1,1,2,0,4
100059,76.0,76.0,76.0,2,1,2,0,5
100069,100.0,100.0,100.0,0,0,0,1,1
100072,89.0,89.0,89.0,1,0,1,0,2
100083,92.0,92.0,92.0,0,0,2,0,2
100098,86.0,86.0,86.0,0,1,3,0,4
100099,85.0,85.0,85.0,1,0,2,0,3
100135,100.0,100.0,100.0,0,0,0,1,1
100215,92.0,92.0,92.0,0,2,1,0,3
100216,84.0,84.0,84.0,0,2,3,0,5
100219,91.0,91.0,91.0,1,1,0,0,2
100239,100.0,100.0,100.0,0,0,0,1,1
100240,94.0,94.0,94.0,0,1,1,0,2
100252,100.0,100.0,100.0,0,0,0,1,1
100255,,,,0,2,0,0,2
100274,100.0,100.0,100.0,0,0,0,1,1
100288,80.0,80.0,80.0,2,1,1,0,4
100330,86.0,86.0,86.0,0,3,2,0,5
100331,88.0,88.0,88.0,0,2,2,0,4
100362,96.0,96.0,96.0,0,0,1,0,1
100378,98.0,98.0,98.0,0,1,0,0,1
100416,87.0,87.0,87.0,1,1,1,0,3
100440,87.0,87.0,87.0,1,1,1,0,3
100475,96.0,96.0,96.0,0,2,0,0,2
100477,96.0,96.0,96.0,0,0,1,0,1
100479,96.0,96.0,96.0,0,0,1,0,1
100480,91.0,91.0,91.0,1,1,0,0,2
100504,88.0,88.0,88.0,0,2,2,0,4
100560,88.0,88.0,88.0,0,0,3,0,3
100579,85.0,85.0,85.0,1,0,2,0,3
100603,96.0,96.0,96.0,0,2,0,0,2
100639,100.0,100.0,100.0,0,0,0,1,1
100642,90.0,90.0,90.0,0,1,2,0,3
100660,98.0,98.0,98.0,0,1,0,0,1
100707,100.0,100.0,100.0,0,0,0,1,1
100715,96.0,96.0,96.0,0,0,1,0,1
100716,98.0,98.0,98.0,0,1,0,0,1
100781,92.0,92.0,92.0,0,0,2,0,2
100807,98.0,98.0,98.0,0,1,0,0,1
100817,100.0,100.0,100.0,0,0,0,1,1
100870,75.0,75.0,75.0,1,5,2,0,8
100992,88.0,88.0,88.0,0,2,2,0,4
101028,100.0,100.0,100.0,0,0,0,1,1
101170,83.0,83.0,83.0,1,1,2,0,4
101184,92.0,92.0,92.0,0,0,2,0,2
101186,94.0,94.0,94.0,0,1,1,0,2
101189,86.0,86.0,86.0,0,3,2,0,5
101190,92.0,92.0,92.0,0,0,2,0,2
101252,94.0,94.0,94.0,0,1,1,0,2
101294,86.0,86.0,86.0,0,1,3,0,4
101375,90.0,90.0,90.0,0,1,2,0,3
101388,100.0,100.0,100.0,0,0,0,1,1
101389,92.0,92.0,92.0,0,0,2,0,2
101430,96.0,96.0,96.0,0,0,1,0,1
101461,90.0,90.0,90.0,0,3,1,0,4
101499,100.0,100.0,100.0,0,0,0,1,1
101577,100.0,100.0,100.0,0,0,0,1,1
101668,96.0,96.0,96.0,0,0,1,0,1
101671,80.0,80.0,80.0,2,1,1,0,4
101691,98.0,98.0,98.0,0,1,0,0,1
101697,88.0,88.0,88.0,0,2,2,0,4
101771,96.0,96.0,96.0,0,2,0,0,2
101838,87.0,87.0,87.0,1,3,0,0,4
101853,100.0,100.0,100.0,0,0,0,1,1
102257,94.0,94.0,94.0,0,1,1,0,2
102336,82.0,82.0,82.0,2,0,1,0,3
102398,90.0,90.0,90.0,0,1,2,0,3
